,Player,Span,Mat,Inns,Dis,Ct,St,Ct Wk,Ct Fi,MD,D/I,Start,End,Final Region
0,KC Sangakkara ,2000-2015,404,397,501,402,99,383,19,5 (4ct 1st),1.261,2000,2015,SL
1,AC Gilchrist ,1996-2008,287,286,472,417,55,417,0,6 (6ct 0st),1.65,1996,2008,AUS
2,MS Dhoni ,2004-2019,350,345,444,321,123,321,0,6 (5ct 1st),1.286,2004,2019,INDIA
3,MV Boucher ,1998-2011,295,291,425,403,22,402,1,6 (6ct 0st),1.46,1998,2011,SA
4,Moin Khan ,1990-2004,219,217,287,214,73,214,0,5 (5ct 0st),1.3219999999999998,1990,2004,PAK
5,BB McCullum ,2002-2016,260,257,277,262,15,227,35,5 (5ct 0st),1.077,2002,2016,NZ
6,IA Healy ,1988-1997,168,168,233,194,39,194,0,4 (4ct 0st),1.386,1988,1997,AUS
7,Mushfiqur Rahim ,2006-2019,216,215,225,181,44,179,2,5 (5ct 0st),1.046,2006,2019,BDESH
8,Rashid Latif ,1992-2003,166,164,220,182,38,182,0,5 (5ct 0st),1.341,1992,2003,PAK
9,DPMD Jayawardene ,1998-2015,448,443,218,218,0,0,218,4 (4ct 0st),0.492,1998,2015,SL
10,R Dravid ,1996-2011,344,341,210,196,14,72,124,4 (4ct 0st),0.615,1996,2011,INDIA
11,RS Kaluwitharana ,1990-2004,189,188,207,132,75,131,1,5 (4ct 1st),1.101,1990,2004,SL
12,PJL Dujon ,1981-1991,169,168,204,183,21,183,0,4 (4ct 0st),1.214,1981,1991,WI
13,JC Buttler ,2012-2019,142,138,202,171,31,171,0,6 (6ct 0st),1.463,2012,2019,ENG
14,RD Jacobs ,1996-2004,147,145,189,160,29,160,0,6 (5ct 1st),1.3030000000000002,1996,2004,WI
15,Kamran Akmal ,2002-2017,157,154,188,157,31,156,1,5 (4ct 1st),1.22,2002,2017,PAK
16,D Ramdin ,2005-2016,139,137,188,181,7,181,0,5 (5ct 0st),1.372,2005,2016,WI
17,AB de Villiers ,2005-2018,228,223,181,176,5,93,83,5 (5ct 0st),0.8109999999999999,2005,2018,SA
18,BJ Haddin ,2001-2015,126,124,181,170,11,170,0,5 (5ct 0st),1.459,2001,2015,AUS
19,AJ Stewart ,1989-2003,170,169,174,159,15,148,11,6 (6ct 0st),1.029,1989,2003,ENG
20,A Flower ,1992-2003,213,212,173,141,32,133,8,5 (5ct 0st),0.816,1992,2003,ZIM
21,Q de Kock ,2013-2019,115,111,166,158,8,158,0,6 (5ct 1st),1.495,2013,2019,SA
22,DJ Richardson ,1991-1998,122,121,165,148,17,148,0,5 (5ct 0st),1.3630000000000002,1991,1998,SA
23,RT Ponting ,1995-2012,375,372,160,160,0,0,160,3 (3ct 0st),0.43,1995,2012,AUS
24,M Azharuddin ,1985-2000,334,332,156,156,0,0,156,4 (4ct 0st),0.469,1985,2000,INDIA
25,NR Mongia ,1994-2000,140,139,154,110,44,110,0,5 (4ct 1st),1.107,1994,2000,INDIA
26,BRM Taylor ,2004-2019,193,193,154,125,29,96,29,5 (5ct 0st),0.797,2004,2019,ZIM
27,T Taibu ,2001-2012,150,150,147,114,33,112,2,4 (4ct 0st),0.98,2001,2012,ZIM
28,AC Parore ,1992-2002,179,178,141,116,25,111,5,5 (3ct 2st),0.792,1992,2002,NZ
29,Sarfaraz Ahmed ,2007-2019,116,114,140,116,24,116,0,6 (6ct 0st),1.228,2007,2019,PAK
30,SR Tendulkar ,1989-2012,463,456,140,140,0,0,140,4 (4ct 0st),0.307,1989,2012,INDIA
31,LRPL Taylor ,2006-2019,228,224,137,137,0,0,137,4 (4ct 0st),0.611,2006,2019,NZ
32,Younis Khan ,2000-2015,265,260,135,135,0,5,130,4 (4ct 0st),0.519,2000,2015,PAK
33,SP Fleming ,1994-2007,280,276,133,133,0,0,133,4 (4ct 0st),0.481,1994,2007,NZ
34,JH Kallis ,1996-2014,328,324,131,131,0,0,131,3 (3ct 0st),0.4039999999999999,1996,2014,SA
35,M Muralitharan ,1993-2011,350,347,130,130,0,0,130,3 (3ct 0st),0.374,1993,2011,SL
36,AR Border ,1979-1994,273,270,127,127,0,0,127,3 (3ct 0st),0.47,1979,1994,AUS
37,Shahid Afridi ,1996-2015,398,392,127,127,0,0,127,2 (2ct 0st),0.3229999999999999,1996,2015,PAK
38,Khaled Mashud ,1995-2006,126,126,126,91,35,91,0,5 (3ct 2st),1.0,1995,2006,BDESH
39,TM Dilshan ,1999-2016,330,325,124,123,1,5,118,3 (3ct 0st),0.381,1999,2016,SL
40,CH Gayle ,1999-2019,301,294,124,124,0,0,124,3 (3ct 0st),0.421,1999,2019,WI
41,V Kohli ,2008-2019,242,240,124,124,0,0,124,3 (3ct 0st),0.516,2008,2019,INDIA
42,RW Marsh ,1971-1984,92,92,124,120,4,120,0,5 (5ct 0st),1.347,1971,1984,AUS
43,ST Jayasuriya ,1989-2011,445,441,123,123,0,0,123,3 (3ct 0st),0.278,1989,2011,SL
44,CL Hooper ,1987-2003,227,225,120,120,0,0,120,4 (4ct 0st),0.5329999999999999,1987,2003,WI
45,BC Lara ,1990-2007,299,296,120,120,0,0,120,3 (3ct 0st),0.405,1990,2007,WI
46,L Ronchi ,2008-2017,85,83,117,105,12,105,0,4 (4ct 0st),1.409,2008,2017,AUS
47,MS Wade ,2012-2017,94,94,117,108,9,108,0,5 (5ct 0st),1.244,2012,2017,AUS
48,Inzamam-ul-Haq ,1991-2007,378,373,113,113,0,0,113,3 (3ct 0st),0.302,1991,2007,PAK
49,SR Waugh ,1986-2002,325,324,111,111,0,0,111,3 (3ct 0st),0.342,1986,2002,AUS
50,KC Sangakkara ,2000-2015,404,397,501,402,99,383,19,5 (4ct 1st),1.261,2000,2015,SL
51,AC Gilchrist ,1996-2008,287,286,472,417,55,417,0,6 (6ct 0st),1.65,1996,2008,AUS
52,MS Dhoni ,2004-2019,350,345,444,321,123,321,0,6 (5ct 1st),1.286,2004,2019,INDIA
53,MV Boucher ,1998-2011,295,291,425,403,22,402,1,6 (6ct 0st),1.46,1998,2011,SA
54,Moin Khan ,1990-2004,219,217,287,214,73,214,0,5 (5ct 0st),1.3219999999999998,1990,2004,PAK
55,BB McCullum ,2002-2016,260,257,277,262,15,227,35,5 (5ct 0st),1.077,2002,2016,NZ
56,IA Healy ,1988-1997,168,168,233,194,39,194,0,4 (4ct 0st),1.386,1988,1997,AUS
57,Mushfiqur Rahim ,2006-2019,216,215,225,181,44,179,2,5 (5ct 0st),1.046,2006,2019,BDESH
58,Rashid Latif ,1992-2003,166,164,220,182,38,182,0,5 (5ct 0st),1.341,1992,2003,PAK
59,DPMD Jayawardene ,1998-2015,448,443,218,218,0,0,218,4 (4ct 0st),0.492,1998,2015,SL
60,R Dravid ,1996-2011,344,341,210,196,14,72,124,4 (4ct 0st),0.615,1996,2011,INDIA
61,RS Kaluwitharana ,1990-2004,189,188,207,132,75,131,1,5 (4ct 1st),1.101,1990,2004,SL
62,PJL Dujon ,1981-1991,169,168,204,183,21,183,0,4 (4ct 0st),1.214,1981,1991,WI
63,JC Buttler ,2012-2019,142,138,202,171,31,171,0,6 (6ct 0st),1.463,2012,2019,ENG
64,RD Jacobs ,1996-2004,147,145,189,160,29,160,0,6 (5ct 1st),1.3030000000000002,1996,2004,WI
65,Kamran Akmal ,2002-2017,157,154,188,157,31,156,1,5 (4ct 1st),1.22,2002,2017,PAK
66,D Ramdin ,2005-2016,139,137,188,181,7,181,0,5 (5ct 0st),1.372,2005,2016,WI
67,AB de Villiers ,2005-2018,228,223,181,176,5,93,83,5 (5ct 0st),0.8109999999999999,2005,2018,SA
68,BJ Haddin ,2001-2015,126,124,181,170,11,170,0,5 (5ct 0st),1.459,2001,2015,AUS
69,AJ Stewart ,1989-2003,170,169,174,159,15,148,11,6 (6ct 0st),1.029,1989,2003,ENG
70,A Flower ,1992-2003,213,212,173,141,32,133,8,5 (5ct 0st),0.816,1992,2003,ZIM
71,Q de Kock ,2013-2019,115,111,166,158,8,158,0,6 (5ct 1st),1.495,2013,2019,SA
72,DJ Richardson ,1991-1998,122,121,165,148,17,148,0,5 (5ct 0st),1.3630000000000002,1991,1998,SA
73,RT Ponting ,1995-2012,375,372,160,160,0,0,160,3 (3ct 0st),0.43,1995,2012,AUS
74,M Azharuddin ,1985-2000,334,332,156,156,0,0,156,4 (4ct 0st),0.469,1985,2000,INDIA
75,NR Mongia ,1994-2000,140,139,154,110,44,110,0,5 (4ct 1st),1.107,1994,2000,INDIA
76,BRM Taylor ,2004-2019,193,193,154,125,29,96,29,5 (5ct 0st),0.797,2004,2019,ZIM
77,T Taibu ,2001-2012,150,150,147,114,33,112,2,4 (4ct 0st),0.98,2001,2012,ZIM
78,AC Parore ,1992-2002,179,178,141,116,25,111,5,5 (3ct 2st),0.792,1992,2002,NZ
79,Sarfaraz Ahmed ,2007-2019,116,114,140,116,24,116,0,6 (6ct 0st),1.228,2007,2019,PAK
80,SR Tendulkar ,1989-2012,463,456,140,140,0,0,140,4 (4ct 0st),0.307,1989,2012,INDIA
81,LRPL Taylor ,2006-2019,228,224,137,137,0,0,137,4 (4ct 0st),0.611,2006,2019,NZ
82,Younis Khan ,2000-2015,265,260,135,135,0,5,130,4 (4ct 0st),0.519,2000,2015,PAK
83,SP Fleming ,1994-2007,280,276,133,133,0,0,133,4 (4ct 0st),0.481,1994,2007,NZ
84,JH Kallis ,1996-2014,328,324,131,131,0,0,131,3 (3ct 0st),0.4039999999999999,1996,2014,SA
85,M Muralitharan ,1993-2011,350,347,130,130,0,0,130,3 (3ct 0st),0.374,1993,2011,SL
86,AR Border ,1979-1994,273,270,127,127,0,0,127,3 (3ct 0st),0.47,1979,1994,AUS
87,Shahid Afridi ,1996-2015,398,392,127,127,0,0,127,2 (2ct 0st),0.3229999999999999,1996,2015,PAK
88,Khaled Mashud ,1995-2006,126,126,126,91,35,91,0,5 (3ct 2st),1.0,1995,2006,BDESH
89,TM Dilshan ,1999-2016,330,325,124,123,1,5,118,3 (3ct 0st),0.381,1999,2016,SL
90,CH Gayle ,1999-2019,301,294,124,124,0,0,124,3 (3ct 0st),0.421,1999,2019,WI
91,V Kohli ,2008-2019,242,240,124,124,0,0,124,3 (3ct 0st),0.516,2008,2019,INDIA
92,RW Marsh ,1971-1984,92,92,124,120,4,120,0,5 (5ct 0st),1.347,1971,1984,AUS
93,ST Jayasuriya ,1989-2011,445,441,123,123,0,0,123,3 (3ct 0st),0.278,1989,2011,SL
94,CL Hooper ,1987-2003,227,225,120,120,0,0,120,4 (4ct 0st),0.5329999999999999,1987,2003,WI
95,BC Lara ,1990-2007,299,296,120,120,0,0,120,3 (3ct 0st),0.405,1990,2007,WI
96,L Ronchi ,2008-2017,85,83,117,105,12,105,0,4 (4ct 0st),1.409,2008,2017,AUS
97,MS Wade ,2012-2017,94,94,117,108,9,108,0,5 (5ct 0st),1.244,2012,2017,AUS
98,Inzamam-ul-Haq ,1991-2007,378,373,113,113,0,0,113,3 (3ct 0st),0.302,1991,2007,PAK
99,SR Waugh ,1986-2002,325,324,111,111,0,0,111,3 (3ct 0st),0.342,1986,2002,AUS
100,KC Sangakkara ,2000-2015,404,397,501,402,99,383,19,5 (4ct 1st),1.261,2000,2015,SL
101,AC Gilchrist ,1996-2008,287,286,472,417,55,417,0,6 (6ct 0st),1.65,1996,2008,AUS
102,MS Dhoni ,2004-2019,350,345,444,321,123,321,0,6 (5ct 1st),1.286,2004,2019,INDIA
103,MV Boucher ,1998-2011,295,291,425,403,22,402,1,6 (6ct 0st),1.46,1998,2011,SA
104,Moin Khan ,1990-2004,219,217,287,214,73,214,0,5 (5ct 0st),1.3219999999999998,1990,2004,PAK
105,BB McCullum ,2002-2016,260,257,277,262,15,227,35,5 (5ct 0st),1.077,2002,2016,NZ
106,IA Healy ,1988-1997,168,168,233,194,39,194,0,4 (4ct 0st),1.386,1988,1997,AUS
107,Mushfiqur Rahim ,2006-2019,216,215,225,181,44,179,2,5 (5ct 0st),1.046,2006,2019,BDESH
108,Rashid Latif ,1992-2003,166,164,220,182,38,182,0,5 (5ct 0st),1.341,1992,2003,PAK
109,DPMD Jayawardene ,1998-2015,448,443,218,218,0,0,218,4 (4ct 0st),0.492,1998,2015,SL
110,R Dravid ,1996-2011,344,341,210,196,14,72,124,4 (4ct 0st),0.615,1996,2011,INDIA
111,RS Kaluwitharana ,1990-2004,189,188,207,132,75,131,1,5 (4ct 1st),1.101,1990,2004,SL
112,PJL Dujon ,1981-1991,169,168,204,183,21,183,0,4 (4ct 0st),1.214,1981,1991,WI
113,JC Buttler ,2012-2019,142,138,202,171,31,171,0,6 (6ct 0st),1.463,2012,2019,ENG
114,RD Jacobs ,1996-2004,147,145,189,160,29,160,0,6 (5ct 1st),1.3030000000000002,1996,2004,WI
115,Kamran Akmal ,2002-2017,157,154,188,157,31,156,1,5 (4ct 1st),1.22,2002,2017,PAK
116,D Ramdin ,2005-2016,139,137,188,181,7,181,0,5 (5ct 0st),1.372,2005,2016,WI
117,AB de Villiers ,2005-2018,228,223,181,176,5,93,83,5 (5ct 0st),0.8109999999999999,2005,2018,SA
118,BJ Haddin ,2001-2015,126,124,181,170,11,170,0,5 (5ct 0st),1.459,2001,2015,AUS
119,AJ Stewart ,1989-2003,170,169,174,159,15,148,11,6 (6ct 0st),1.029,1989,2003,ENG
120,A Flower ,1992-2003,213,212,173,141,32,133,8,5 (5ct 0st),0.816,1992,2003,ZIM
121,Q de Kock ,2013-2019,115,111,166,158,8,158,0,6 (5ct 1st),1.495,2013,2019,SA
122,DJ Richardson ,1991-1998,122,121,165,148,17,148,0,5 (5ct 0st),1.3630000000000002,1991,1998,SA
123,RT Ponting ,1995-2012,375,372,160,160,0,0,160,3 (3ct 0st),0.43,1995,2012,AUS
124,M Azharuddin ,1985-2000,334,332,156,156,0,0,156,4 (4ct 0st),0.469,1985,2000,INDIA
125,NR Mongia ,1994-2000,140,139,154,110,44,110,0,5 (4ct 1st),1.107,1994,2000,INDIA
126,BRM Taylor ,2004-2019,193,193,154,125,29,96,29,5 (5ct 0st),0.797,2004,2019,ZIM
127,T Taibu ,2001-2012,150,150,147,114,33,112,2,4 (4ct 0st),0.98,2001,2012,ZIM
128,AC Parore ,1992-2002,179,178,141,116,25,111,5,5 (3ct 2st),0.792,1992,2002,NZ
129,Sarfaraz Ahmed ,2007-2019,116,114,140,116,24,116,0,6 (6ct 0st),1.228,2007,2019,PAK
130,SR Tendulkar ,1989-2012,463,456,140,140,0,0,140,4 (4ct 0st),0.307,1989,2012,INDIA
131,LRPL Taylor ,2006-2019,228,224,137,137,0,0,137,4 (4ct 0st),0.611,2006,2019,NZ
132,Younis Khan ,2000-2015,265,260,135,135,0,5,130,4 (4ct 0st),0.519,2000,2015,PAK
133,SP Fleming ,1994-2007,280,276,133,133,0,0,133,4 (4ct 0st),0.481,1994,2007,NZ
134,JH Kallis ,1996-2014,328,324,131,131,0,0,131,3 (3ct 0st),0.4039999999999999,1996,2014,SA
135,M Muralitharan ,1993-2011,350,347,130,130,0,0,130,3 (3ct 0st),0.374,1993,2011,SL
136,AR Border ,1979-1994,273,270,127,127,0,0,127,3 (3ct 0st),0.47,1979,1994,AUS
137,Shahid Afridi ,1996-2015,398,392,127,127,0,0,127,2 (2ct 0st),0.3229999999999999,1996,2015,PAK
138,Khaled Mashud ,1995-2006,126,126,126,91,35,91,0,5 (3ct 2st),1.0,1995,2006,BDESH
139,TM Dilshan ,1999-2016,330,325,124,123,1,5,118,3 (3ct 0st),0.381,1999,2016,SL
140,CH Gayle ,1999-2019,301,294,124,124,0,0,124,3 (3ct 0st),0.421,1999,2019,WI
141,V Kohli ,2008-2019,242,240,124,124,0,0,124,3 (3ct 0st),0.516,2008,2019,INDIA
142,RW Marsh ,1971-1984,92,92,124,120,4,120,0,5 (5ct 0st),1.347,1971,1984,AUS
143,ST Jayasuriya ,1989-2011,445,441,123,123,0,0,123,3 (3ct 0st),0.278,1989,2011,SL
144,CL Hooper ,1987-2003,227,225,120,120,0,0,120,4 (4ct 0st),0.5329999999999999,1987,2003,WI
145,BC Lara ,1990-2007,299,296,120,120,0,0,120,3 (3ct 0st),0.405,1990,2007,WI
146,L Ronchi ,2008-2017,85,83,117,105,12,105,0,4 (4ct 0st),1.409,2008,2017,AUS
147,MS Wade ,2012-2017,94,94,117,108,9,108,0,5 (5ct 0st),1.244,2012,2017,AUS
148,Inzamam-ul-Haq ,1991-2007,378,373,113,113,0,0,113,3 (3ct 0st),0.302,1991,2007,PAK
149,SR Waugh ,1986-2002,325,324,111,111,0,0,111,3 (3ct 0st),0.342,1986,2002,AUS
150,KC Sangakkara ,2000-2015,404,397,501,402,99,383,19,5 (4ct 1st),1.261,2000,2015,SL
151,AC Gilchrist ,1996-2008,287,286,472,417,55,417,0,6 (6ct 0st),1.65,1996,2008,AUS
152,MS Dhoni ,2004-2019,350,345,444,321,123,321,0,6 (5ct 1st),1.286,2004,2019,INDIA
153,MV Boucher ,1998-2011,295,291,425,403,22,402,1,6 (6ct 0st),1.46,1998,2011,SA
154,Moin Khan ,1990-2004,219,217,287,214,73,214,0,5 (5ct 0st),1.3219999999999998,1990,2004,PAK
155,BB McCullum ,2002-2016,260,257,277,262,15,227,35,5 (5ct 0st),1.077,2002,2016,NZ
156,IA Healy ,1988-1997,168,168,233,194,39,194,0,4 (4ct 0st),1.386,1988,1997,AUS
157,Mushfiqur Rahim ,2006-2019,216,215,225,181,44,179,2,5 (5ct 0st),1.046,2006,2019,BDESH
158,Rashid Latif ,1992-2003,166,164,220,182,38,182,0,5 (5ct 0st),1.341,1992,2003,PAK
159,DPMD Jayawardene ,1998-2015,448,443,218,218,0,0,218,4 (4ct 0st),0.492,1998,2015,SL
160,R Dravid ,1996-2011,344,341,210,196,14,72,124,4 (4ct 0st),0.615,1996,2011,INDIA
161,RS Kaluwitharana ,1990-2004,189,188,207,132,75,131,1,5 (4ct 1st),1.101,1990,2004,SL
162,PJL Dujon ,1981-1991,169,168,204,183,21,183,0,4 (4ct 0st),1.214,1981,1991,WI
163,JC Buttler ,2012-2019,142,138,202,171,31,171,0,6 (6ct 0st),1.463,2012,2019,ENG
164,RD Jacobs ,1996-2004,147,145,189,160,29,160,0,6 (5ct 1st),1.3030000000000002,1996,2004,WI
165,Kamran Akmal ,2002-2017,157,154,188,157,31,156,1,5 (4ct 1st),1.22,2002,2017,PAK
166,D Ramdin ,2005-2016,139,137,188,181,7,181,0,5 (5ct 0st),1.372,2005,2016,WI
167,AB de Villiers ,2005-2018,228,223,181,176,5,93,83,5 (5ct 0st),0.8109999999999999,2005,2018,SA
168,BJ Haddin ,2001-2015,126,124,181,170,11,170,0,5 (5ct 0st),1.459,2001,2015,AUS
169,AJ Stewart ,1989-2003,170,169,174,159,15,148,11,6 (6ct 0st),1.029,1989,2003,ENG
170,A Flower ,1992-2003,213,212,173,141,32,133,8,5 (5ct 0st),0.816,1992,2003,ZIM
171,Q de Kock ,2013-2019,115,111,166,158,8,158,0,6 (5ct 1st),1.495,2013,2019,SA
172,DJ Richardson ,1991-1998,122,121,165,148,17,148,0,5 (5ct 0st),1.3630000000000002,1991,1998,SA
173,RT Ponting ,1995-2012,375,372,160,160,0,0,160,3 (3ct 0st),0.43,1995,2012,AUS
174,M Azharuddin ,1985-2000,334,332,156,156,0,0,156,4 (4ct 0st),0.469,1985,2000,INDIA
175,NR Mongia ,1994-2000,140,139,154,110,44,110,0,5 (4ct 1st),1.107,1994,2000,INDIA
176,BRM Taylor ,2004-2019,193,193,154,125,29,96,29,5 (5ct 0st),0.797,2004,2019,ZIM
177,T Taibu ,2001-2012,150,150,147,114,33,112,2,4 (4ct 0st),0.98,2001,2012,ZIM
178,AC Parore ,1992-2002,179,178,141,116,25,111,5,5 (3ct 2st),0.792,1992,2002,NZ
179,Sarfaraz Ahmed ,2007-2019,116,114,140,116,24,116,0,6 (6ct 0st),1.228,2007,2019,PAK
180,SR Tendulkar ,1989-2012,463,456,140,140,0,0,140,4 (4ct 0st),0.307,1989,2012,INDIA
181,LRPL Taylor ,2006-2019,228,224,137,137,0,0,137,4 (4ct 0st),0.611,2006,2019,NZ
182,Younis Khan ,2000-2015,265,260,135,135,0,5,130,4 (4ct 0st),0.519,2000,2015,PAK
183,SP Fleming ,1994-2007,280,276,133,133,0,0,133,4 (4ct 0st),0.481,1994,2007,NZ
184,JH Kallis ,1996-2014,328,324,131,131,0,0,131,3 (3ct 0st),0.4039999999999999,1996,2014,SA
185,M Muralitharan ,1993-2011,350,347,130,130,0,0,130,3 (3ct 0st),0.374,1993,2011,SL
186,AR Border ,1979-1994,273,270,127,127,0,0,127,3 (3ct 0st),0.47,1979,1994,AUS
187,Shahid Afridi ,1996-2015,398,392,127,127,0,0,127,2 (2ct 0st),0.3229999999999999,1996,2015,PAK
188,Khaled Mashud ,1995-2006,126,126,126,91,35,91,0,5 (3ct 2st),1.0,1995,2006,BDESH
189,TM Dilshan ,1999-2016,330,325,124,123,1,5,118,3 (3ct 0st),0.381,1999,2016,SL
190,CH Gayle ,1999-2019,301,294,124,124,0,0,124,3 (3ct 0st),0.421,1999,2019,WI
191,V Kohli ,2008-2019,242,240,124,124,0,0,124,3 (3ct 0st),0.516,2008,2019,INDIA
192,RW Marsh ,1971-1984,92,92,124,120,4,120,0,5 (5ct 0st),1.347,1971,1984,AUS
193,ST Jayasuriya ,1989-2011,445,441,123,123,0,0,123,3 (3ct 0st),0.278,1989,2011,SL
194,CL Hooper ,1987-2003,227,225,120,120,0,0,120,4 (4ct 0st),0.5329999999999999,1987,2003,WI
195,BC Lara ,1990-2007,299,296,120,120,0,0,120,3 (3ct 0st),0.405,1990,2007,WI
196,L Ronchi ,2008-2017,85,83,117,105,12,105,0,4 (4ct 0st),1.409,2008,2017,AUS
197,MS Wade ,2012-2017,94,94,117,108,9,108,0,5 (5ct 0st),1.244,2012,2017,AUS
198,Inzamam-ul-Haq ,1991-2007,378,373,113,113,0,0,113,3 (3ct 0st),0.302,1991,2007,PAK
199,SR Waugh ,1986-2002,325,324,111,111,0,0,111,3 (3ct 0st),0.342,1986,2002,AUS
200,KC Sangakkara ,2000-2015,404,397,501,402,99,383,19,5 (4ct 1st),1.261,2000,2015,SL
201,AC Gilchrist ,1996-2008,287,286,472,417,55,417,0,6 (6ct 0st),1.65,1996,2008,AUS
202,MS Dhoni ,2004-2019,350,345,444,321,123,321,0,6 (5ct 1st),1.286,2004,2019,INDIA
203,MV Boucher ,1998-2011,295,291,425,403,22,402,1,6 (6ct 0st),1.46,1998,2011,SA
204,Moin Khan ,1990-2004,219,217,287,214,73,214,0,5 (5ct 0st),1.3219999999999998,1990,2004,PAK
205,BB McCullum ,2002-2016,260,257,277,262,15,227,35,5 (5ct 0st),1.077,2002,2016,NZ
206,IA Healy ,1988-1997,168,168,233,194,39,194,0,4 (4ct 0st),1.386,1988,1997,AUS
207,Mushfiqur Rahim ,2006-2019,216,215,225,181,44,179,2,5 (5ct 0st),1.046,2006,2019,BDESH
208,Rashid Latif ,1992-2003,166,164,220,182,38,182,0,5 (5ct 0st),1.341,1992,2003,PAK
209,DPMD Jayawardene ,1998-2015,448,443,218,218,0,0,218,4 (4ct 0st),0.492,1998,2015,SL
210,R Dravid ,1996-2011,344,341,210,196,14,72,124,4 (4ct 0st),0.615,1996,2011,INDIA
211,RS Kaluwitharana ,1990-2004,189,188,207,132,75,131,1,5 (4ct 1st),1.101,1990,2004,SL
212,PJL Dujon ,1981-1991,169,168,204,183,21,183,0,4 (4ct 0st),1.214,1981,1991,WI
213,JC Buttler ,2012-2019,142,138,202,171,31,171,0,6 (6ct 0st),1.463,2012,2019,ENG
214,RD Jacobs ,1996-2004,147,145,189,160,29,160,0,6 (5ct 1st),1.3030000000000002,1996,2004,WI
215,Kamran Akmal ,2002-2017,157,154,188,157,31,156,1,5 (4ct 1st),1.22,2002,2017,PAK
216,D Ramdin ,2005-2016,139,137,188,181,7,181,0,5 (5ct 0st),1.372,2005,2016,WI
217,AB de Villiers ,2005-2018,228,223,181,176,5,93,83,5 (5ct 0st),0.8109999999999999,2005,2018,SA
218,BJ Haddin ,2001-2015,126,124,181,170,11,170,0,5 (5ct 0st),1.459,2001,2015,AUS
219,AJ Stewart ,1989-2003,170,169,174,159,15,148,11,6 (6ct 0st),1.029,1989,2003,ENG
220,A Flower ,1992-2003,213,212,173,141,32,133,8,5 (5ct 0st),0.816,1992,2003,ZIM
221,Q de Kock ,2013-2019,115,111,166,158,8,158,0,6 (5ct 1st),1.495,2013,2019,SA
222,DJ Richardson ,1991-1998,122,121,165,148,17,148,0,5 (5ct 0st),1.3630000000000002,1991,1998,SA
223,RT Ponting ,1995-2012,375,372,160,160,0,0,160,3 (3ct 0st),0.43,1995,2012,AUS
224,M Azharuddin ,1985-2000,334,332,156,156,0,0,156,4 (4ct 0st),0.469,1985,2000,INDIA
225,NR Mongia ,1994-2000,140,139,154,110,44,110,0,5 (4ct 1st),1.107,1994,2000,INDIA
226,BRM Taylor ,2004-2019,193,193,154,125,29,96,29,5 (5ct 0st),0.797,2004,2019,ZIM
227,T Taibu ,2001-2012,150,150,147,114,33,112,2,4 (4ct 0st),0.98,2001,2012,ZIM
228,AC Parore ,1992-2002,179,178,141,116,25,111,5,5 (3ct 2st),0.792,1992,2002,NZ
229,Sarfaraz Ahmed ,2007-2019,116,114,140,116,24,116,0,6 (6ct 0st),1.228,2007,2019,PAK
230,SR Tendulkar ,1989-2012,463,456,140,140,0,0,140,4 (4ct 0st),0.307,1989,2012,INDIA
231,LRPL Taylor ,2006-2019,228,224,137,137,0,0,137,4 (4ct 0st),0.611,2006,2019,NZ
232,Younis Khan ,2000-2015,265,260,135,135,0,5,130,4 (4ct 0st),0.519,2000,2015,PAK
233,SP Fleming ,1994-2007,280,276,133,133,0,0,133,4 (4ct 0st),0.481,1994,2007,NZ
234,JH Kallis ,1996-2014,328,324,131,131,0,0,131,3 (3ct 0st),0.4039999999999999,1996,2014,SA
235,M Muralitharan ,1993-2011,350,347,130,130,0,0,130,3 (3ct 0st),0.374,1993,2011,SL
236,AR Border ,1979-1994,273,270,127,127,0,0,127,3 (3ct 0st),0.47,1979,1994,AUS
237,Shahid Afridi ,1996-2015,398,392,127,127,0,0,127,2 (2ct 0st),0.3229999999999999,1996,2015,PAK
238,Khaled Mashud ,1995-2006,126,126,126,91,35,91,0,5 (3ct 2st),1.0,1995,2006,BDESH
239,TM Dilshan ,1999-2016,330,325,124,123,1,5,118,3 (3ct 0st),0.381,1999,2016,SL
240,CH Gayle ,1999-2019,301,294,124,124,0,0,124,3 (3ct 0st),0.421,1999,2019,WI
241,V Kohli ,2008-2019,242,240,124,124,0,0,124,3 (3ct 0st),0.516,2008,2019,INDIA
242,RW Marsh ,1971-1984,92,92,124,120,4,120,0,5 (5ct 0st),1.347,1971,1984,AUS
243,ST Jayasuriya ,1989-2011,445,441,123,123,0,0,123,3 (3ct 0st),0.278,1989,2011,SL
244,CL Hooper ,1987-2003,227,225,120,120,0,0,120,4 (4ct 0st),0.5329999999999999,1987,2003,WI
245,BC Lara ,1990-2007,299,296,120,120,0,0,120,3 (3ct 0st),0.405,1990,2007,WI
246,L Ronchi ,2008-2017,85,83,117,105,12,105,0,4 (4ct 0st),1.409,2008,2017,AUS
247,MS Wade ,2012-2017,94,94,117,108,9,108,0,5 (5ct 0st),1.244,2012,2017,AUS
248,Inzamam-ul-Haq ,1991-2007,378,373,113,113,0,0,113,3 (3ct 0st),0.302,1991,2007,PAK
249,SR Waugh ,1986-2002,325,324,111,111,0,0,111,3 (3ct 0st),0.342,1986,2002,AUS
250,KC Sangakkara ,2000-2015,404,397,501,402,99,383,19,5 (4ct 1st),1.261,2000,2015,SL
251,AC Gilchrist ,1996-2008,287,286,472,417,55,417,0,6 (6ct 0st),1.65,1996,2008,AUS
252,MS Dhoni ,2004-2019,350,345,444,321,123,321,0,6 (5ct 1st),1.286,2004,2019,INDIA
253,MV Boucher ,1998-2011,295,291,425,403,22,402,1,6 (6ct 0st),1.46,1998,2011,SA
254,Moin Khan ,1990-2004,219,217,287,214,73,214,0,5 (5ct 0st),1.3219999999999998,1990,2004,PAK
255,BB McCullum ,2002-2016,260,257,277,262,15,227,35,5 (5ct 0st),1.077,2002,2016,NZ
256,IA Healy ,1988-1997,168,168,233,194,39,194,0,4 (4ct 0st),1.386,1988,1997,AUS
257,Mushfiqur Rahim ,2006-2019,216,215,225,181,44,179,2,5 (5ct 0st),1.046,2006,2019,BDESH
258,Rashid Latif ,1992-2003,166,164,220,182,38,182,0,5 (5ct 0st),1.341,1992,2003,PAK
259,DPMD Jayawardene ,1998-2015,448,443,218,218,0,0,218,4 (4ct 0st),0.492,1998,2015,SL
260,R Dravid ,1996-2011,344,341,210,196,14,72,124,4 (4ct 0st),0.615,1996,2011,INDIA
261,RS Kaluwitharana ,1990-2004,189,188,207,132,75,131,1,5 (4ct 1st),1.101,1990,2004,SL
262,PJL Dujon ,1981-1991,169,168,204,183,21,183,0,4 (4ct 0st),1.214,1981,1991,WI
263,JC Buttler ,2012-2019,142,138,202,171,31,171,0,6 (6ct 0st),1.463,2012,2019,ENG
264,RD Jacobs ,1996-2004,147,145,189,160,29,160,0,6 (5ct 1st),1.3030000000000002,1996,2004,WI
265,Kamran Akmal ,2002-2017,157,154,188,157,31,156,1,5 (4ct 1st),1.22,2002,2017,PAK
266,D Ramdin ,2005-2016,139,137,188,181,7,181,0,5 (5ct 0st),1.372,2005,2016,WI
267,AB de Villiers ,2005-2018,228,223,181,176,5,93,83,5 (5ct 0st),0.8109999999999999,2005,2018,SA
268,BJ Haddin ,2001-2015,126,124,181,170,11,170,0,5 (5ct 0st),1.459,2001,2015,AUS
269,AJ Stewart ,1989-2003,170,169,174,159,15,148,11,6 (6ct 0st),1.029,1989,2003,ENG
270,A Flower ,1992-2003,213,212,173,141,32,133,8,5 (5ct 0st),0.816,1992,2003,ZIM
271,Q de Kock ,2013-2019,115,111,166,158,8,158,0,6 (5ct 1st),1.495,2013,2019,SA
272,DJ Richardson ,1991-1998,122,121,165,148,17,148,0,5 (5ct 0st),1.3630000000000002,1991,1998,SA
273,RT Ponting ,1995-2012,375,372,160,160,0,0,160,3 (3ct 0st),0.43,1995,2012,AUS
274,M Azharuddin ,1985-2000,334,332,156,156,0,0,156,4 (4ct 0st),0.469,1985,2000,INDIA
275,NR Mongia ,1994-2000,140,139,154,110,44,110,0,5 (4ct 1st),1.107,1994,2000,INDIA
276,BRM Taylor ,2004-2019,193,193,154,125,29,96,29,5 (5ct 0st),0.797,2004,2019,ZIM
277,T Taibu ,2001-2012,150,150,147,114,33,112,2,4 (4ct 0st),0.98,2001,2012,ZIM
278,AC Parore ,1992-2002,179,178,141,116,25,111,5,5 (3ct 2st),0.792,1992,2002,NZ
279,Sarfaraz Ahmed ,2007-2019,116,114,140,116,24,116,0,6 (6ct 0st),1.228,2007,2019,PAK
280,SR Tendulkar ,1989-2012,463,456,140,140,0,0,140,4 (4ct 0st),0.307,1989,2012,INDIA
281,LRPL Taylor ,2006-2019,228,224,137,137,0,0,137,4 (4ct 0st),0.611,2006,2019,NZ
282,Younis Khan ,2000-2015,265,260,135,135,0,5,130,4 (4ct 0st),0.519,2000,2015,PAK
283,SP Fleming ,1994-2007,280,276,133,133,0,0,133,4 (4ct 0st),0.481,1994,2007,NZ
284,JH Kallis ,1996-2014,328,324,131,131,0,0,131,3 (3ct 0st),0.4039999999999999,1996,2014,SA
285,M Muralitharan ,1993-2011,350,347,130,130,0,0,130,3 (3ct 0st),0.374,1993,2011,SL
286,AR Border ,1979-1994,273,270,127,127,0,0,127,3 (3ct 0st),0.47,1979,1994,AUS
287,Shahid Afridi ,1996-2015,398,392,127,127,0,0,127,2 (2ct 0st),0.3229999999999999,1996,2015,PAK
288,Khaled Mashud ,1995-2006,126,126,126,91,35,91,0,5 (3ct 2st),1.0,1995,2006,BDESH
289,TM Dilshan ,1999-2016,330,325,124,123,1,5,118,3 (3ct 0st),0.381,1999,2016,SL
290,CH Gayle ,1999-2019,301,294,124,124,0,0,124,3 (3ct 0st),0.421,1999,2019,WI
291,V Kohli ,2008-2019,242,240,124,124,0,0,124,3 (3ct 0st),0.516,2008,2019,INDIA
292,RW Marsh ,1971-1984,92,92,124,120,4,120,0,5 (5ct 0st),1.347,1971,1984,AUS
293,ST Jayasuriya ,1989-2011,445,441,123,123,0,0,123,3 (3ct 0st),0.278,1989,2011,SL
294,CL Hooper ,1987-2003,227,225,120,120,0,0,120,4 (4ct 0st),0.5329999999999999,1987,2003,WI
295,BC Lara ,1990-2007,299,296,120,120,0,0,120,3 (3ct 0st),0.405,1990,2007,WI
296,L Ronchi ,2008-2017,85,83,117,105,12,105,0,4 (4ct 0st),1.409,2008,2017,AUS
297,MS Wade ,2012-2017,94,94,117,108,9,108,0,5 (5ct 0st),1.244,2012,2017,AUS
298,Inzamam-ul-Haq ,1991-2007,378,373,113,113,0,0,113,3 (3ct 0st),0.302,1991,2007,PAK
299,SR Waugh ,1986-2002,325,324,111,111,0,0,111,3 (3ct 0st),0.342,1986,2002,AUS
300,KC Sangakkara ,2000-2015,404,397,501,402,99,383,19,5 (4ct 1st),1.261,2000,2015,SL
301,AC Gilchrist ,1996-2008,287,286,472,417,55,417,0,6 (6ct 0st),1.65,1996,2008,AUS
302,MS Dhoni ,2004-2019,350,345,444,321,123,321,0,6 (5ct 1st),1.286,2004,2019,INDIA
303,MV Boucher ,1998-2011,295,291,425,403,22,402,1,6 (6ct 0st),1.46,1998,2011,SA
304,Moin Khan ,1990-2004,219,217,287,214,73,214,0,5 (5ct 0st),1.3219999999999998,1990,2004,PAK
305,BB McCullum ,2002-2016,260,257,277,262,15,227,35,5 (5ct 0st),1.077,2002,2016,NZ
306,IA Healy ,1988-1997,168,168,233,194,39,194,0,4 (4ct 0st),1.386,1988,1997,AUS
307,Mushfiqur Rahim ,2006-2019,216,215,225,181,44,179,2,5 (5ct 0st),1.046,2006,2019,BDESH
308,Rashid Latif ,1992-2003,166,164,220,182,38,182,0,5 (5ct 0st),1.341,1992,2003,PAK
309,DPMD Jayawardene ,1998-2015,448,443,218,218,0,0,218,4 (4ct 0st),0.492,1998,2015,SL
310,R Dravid ,1996-2011,344,341,210,196,14,72,124,4 (4ct 0st),0.615,1996,2011,INDIA
311,RS Kaluwitharana ,1990-2004,189,188,207,132,75,131,1,5 (4ct 1st),1.101,1990,2004,SL
312,PJL Dujon ,1981-1991,169,168,204,183,21,183,0,4 (4ct 0st),1.214,1981,1991,WI
313,JC Buttler ,2012-2019,142,138,202,171,31,171,0,6 (6ct 0st),1.463,2012,2019,ENG
314,RD Jacobs ,1996-2004,147,145,189,160,29,160,0,6 (5ct 1st),1.3030000000000002,1996,2004,WI
315,Kamran Akmal ,2002-2017,157,154,188,157,31,156,1,5 (4ct 1st),1.22,2002,2017,PAK
316,D Ramdin ,2005-2016,139,137,188,181,7,181,0,5 (5ct 0st),1.372,2005,2016,WI
317,AB de Villiers ,2005-2018,228,223,181,176,5,93,83,5 (5ct 0st),0.8109999999999999,2005,2018,SA
318,BJ Haddin ,2001-2015,126,124,181,170,11,170,0,5 (5ct 0st),1.459,2001,2015,AUS
319,AJ Stewart ,1989-2003,170,169,174,159,15,148,11,6 (6ct 0st),1.029,1989,2003,ENG
320,A Flower ,1992-2003,213,212,173,141,32,133,8,5 (5ct 0st),0.816,1992,2003,ZIM
321,Q de Kock ,2013-2019,115,111,166,158,8,158,0,6 (5ct 1st),1.495,2013,2019,SA
322,DJ Richardson ,1991-1998,122,121,165,148,17,148,0,5 (5ct 0st),1.3630000000000002,1991,1998,SA
323,RT Ponting ,1995-2012,375,372,160,160,0,0,160,3 (3ct 0st),0.43,1995,2012,AUS
324,M Azharuddin ,1985-2000,334,332,156,156,0,0,156,4 (4ct 0st),0.469,1985,2000,INDIA
325,NR Mongia ,1994-2000,140,139,154,110,44,110,0,5 (4ct 1st),1.107,1994,2000,INDIA
326,BRM Taylor ,2004-2019,193,193,154,125,29,96,29,5 (5ct 0st),0.797,2004,2019,ZIM
327,T Taibu ,2001-2012,150,150,147,114,33,112,2,4 (4ct 0st),0.98,2001,2012,ZIM
328,AC Parore ,1992-2002,179,178,141,116,25,111,5,5 (3ct 2st),0.792,1992,2002,NZ
329,Sarfaraz Ahmed ,2007-2019,116,114,140,116,24,116,0,6 (6ct 0st),1.228,2007,2019,PAK
330,SR Tendulkar ,1989-2012,463,456,140,140,0,0,140,4 (4ct 0st),0.307,1989,2012,INDIA
331,LRPL Taylor ,2006-2019,228,224,137,137,0,0,137,4 (4ct 0st),0.611,2006,2019,NZ
332,Younis Khan ,2000-2015,265,260,135,135,0,5,130,4 (4ct 0st),0.519,2000,2015,PAK
333,SP Fleming ,1994-2007,280,276,133,133,0,0,133,4 (4ct 0st),0.481,1994,2007,NZ
334,JH Kallis ,1996-2014,328,324,131,131,0,0,131,3 (3ct 0st),0.4039999999999999,1996,2014,SA
335,M Muralitharan ,1993-2011,350,347,130,130,0,0,130,3 (3ct 0st),0.374,1993,2011,SL
336,AR Border ,1979-1994,273,270,127,127,0,0,127,3 (3ct 0st),0.47,1979,1994,AUS
337,Shahid Afridi ,1996-2015,398,392,127,127,0,0,127,2 (2ct 0st),0.3229999999999999,1996,2015,PAK
338,Khaled Mashud ,1995-2006,126,126,126,91,35,91,0,5 (3ct 2st),1.0,1995,2006,BDESH
339,TM Dilshan ,1999-2016,330,325,124,123,1,5,118,3 (3ct 0st),0.381,1999,2016,SL
340,CH Gayle ,1999-2019,301,294,124,124,0,0,124,3 (3ct 0st),0.421,1999,2019,WI
341,V Kohli ,2008-2019,242,240,124,124,0,0,124,3 (3ct 0st),0.516,2008,2019,INDIA
342,RW Marsh ,1971-1984,92,92,124,120,4,120,0,5 (5ct 0st),1.347,1971,1984,AUS
343,ST Jayasuriya ,1989-2011,445,441,123,123,0,0,123,3 (3ct 0st),0.278,1989,2011,SL
344,CL Hooper ,1987-2003,227,225,120,120,0,0,120,4 (4ct 0st),0.5329999999999999,1987,2003,WI
345,BC Lara ,1990-2007,299,296,120,120,0,0,120,3 (3ct 0st),0.405,1990,2007,WI
346,L Ronchi ,2008-2017,85,83,117,105,12,105,0,4 (4ct 0st),1.409,2008,2017,AUS
347,MS Wade ,2012-2017,94,94,117,108,9,108,0,5 (5ct 0st),1.244,2012,2017,AUS
348,Inzamam-ul-Haq ,1991-2007,378,373,113,113,0,0,113,3 (3ct 0st),0.302,1991,2007,PAK
349,SR Waugh ,1986-2002,325,324,111,111,0,0,111,3 (3ct 0st),0.342,1986,2002,AUS
350,KC Sangakkara ,2000-2015,404,397,501,402,99,383,19,5 (4ct 1st),1.261,2000,2015,SL
351,AC Gilchrist ,1996-2008,287,286,472,417,55,417,0,6 (6ct 0st),1.65,1996,2008,AUS
352,MS Dhoni ,2004-2019,350,345,444,321,123,321,0,6 (5ct 1st),1.286,2004,2019,INDIA
353,MV Boucher ,1998-2011,295,291,425,403,22,402,1,6 (6ct 0st),1.46,1998,2011,SA
354,Moin Khan ,1990-2004,219,217,287,214,73,214,0,5 (5ct 0st),1.3219999999999998,1990,2004,PAK
355,BB McCullum ,2002-2016,260,257,277,262,15,227,35,5 (5ct 0st),1.077,2002,2016,NZ
356,IA Healy ,1988-1997,168,168,233,194,39,194,0,4 (4ct 0st),1.386,1988,1997,AUS
357,Mushfiqur Rahim ,2006-2019,216,215,225,181,44,179,2,5 (5ct 0st),1.046,2006,2019,BDESH
358,Rashid Latif ,1992-2003,166,164,220,182,38,182,0,5 (5ct 0st),1.341,1992,2003,PAK
359,DPMD Jayawardene ,1998-2015,448,443,218,218,0,0,218,4 (4ct 0st),0.492,1998,2015,SL
360,R Dravid ,1996-2011,344,341,210,196,14,72,124,4 (4ct 0st),0.615,1996,2011,INDIA
361,RS Kaluwitharana ,1990-2004,189,188,207,132,75,131,1,5 (4ct 1st),1.101,1990,2004,SL
362,PJL Dujon ,1981-1991,169,168,204,183,21,183,0,4 (4ct 0st),1.214,1981,1991,WI
363,JC Buttler ,2012-2019,142,138,202,171,31,171,0,6 (6ct 0st),1.463,2012,2019,ENG
364,RD Jacobs ,1996-2004,147,145,189,160,29,160,0,6 (5ct 1st),1.3030000000000002,1996,2004,WI
365,Kamran Akmal ,2002-2017,157,154,188,157,31,156,1,5 (4ct 1st),1.22,2002,2017,PAK
366,D Ramdin ,2005-2016,139,137,188,181,7,181,0,5 (5ct 0st),1.372,2005,2016,WI
367,AB de Villiers ,2005-2018,228,223,181,176,5,93,83,5 (5ct 0st),0.8109999999999999,2005,2018,SA
368,BJ Haddin ,2001-2015,126,124,181,170,11,170,0,5 (5ct 0st),1.459,2001,2015,AUS
369,AJ Stewart ,1989-2003,170,169,174,159,15,148,11,6 (6ct 0st),1.029,1989,2003,ENG
370,A Flower ,1992-2003,213,212,173,141,32,133,8,5 (5ct 0st),0.816,1992,2003,ZIM
371,Q de Kock ,2013-2019,115,111,166,158,8,158,0,6 (5ct 1st),1.495,2013,2019,SA
372,DJ Richardson ,1991-1998,122,121,165,148,17,148,0,5 (5ct 0st),1.3630000000000002,1991,1998,SA
373,RT Ponting ,1995-2012,375,372,160,160,0,0,160,3 (3ct 0st),0.43,1995,2012,AUS
374,M Azharuddin ,1985-2000,334,332,156,156,0,0,156,4 (4ct 0st),0.469,1985,2000,INDIA
375,NR Mongia ,1994-2000,140,139,154,110,44,110,0,5 (4ct 1st),1.107,1994,2000,INDIA
376,BRM Taylor ,2004-2019,193,193,154,125,29,96,29,5 (5ct 0st),0.797,2004,2019,ZIM
377,T Taibu ,2001-2012,150,150,147,114,33,112,2,4 (4ct 0st),0.98,2001,2012,ZIM
378,AC Parore ,1992-2002,179,178,141,116,25,111,5,5 (3ct 2st),0.792,1992,2002,NZ
379,Sarfaraz Ahmed ,2007-2019,116,114,140,116,24,116,0,6 (6ct 0st),1.228,2007,2019,PAK
380,SR Tendulkar ,1989-2012,463,456,140,140,0,0,140,4 (4ct 0st),0.307,1989,2012,INDIA
381,LRPL Taylor ,2006-2019,228,224,137,137,0,0,137,4 (4ct 0st),0.611,2006,2019,NZ
382,Younis Khan ,2000-2015,265,260,135,135,0,5,130,4 (4ct 0st),0.519,2000,2015,PAK
383,SP Fleming ,1994-2007,280,276,133,133,0,0,133,4 (4ct 0st),0.481,1994,2007,NZ
384,JH Kallis ,1996-2014,328,324,131,131,0,0,131,3 (3ct 0st),0.4039999999999999,1996,2014,SA
385,M Muralitharan ,1993-2011,350,347,130,130,0,0,130,3 (3ct 0st),0.374,1993,2011,SL
386,AR Border ,1979-1994,273,270,127,127,0,0,127,3 (3ct 0st),0.47,1979,1994,AUS
387,Shahid Afridi ,1996-2015,398,392,127,127,0,0,127,2 (2ct 0st),0.3229999999999999,1996,2015,PAK
388,Khaled Mashud ,1995-2006,126,126,126,91,35,91,0,5 (3ct 2st),1.0,1995,2006,BDESH
389,TM Dilshan ,1999-2016,330,325,124,123,1,5,118,3 (3ct 0st),0.381,1999,2016,SL
390,CH Gayle ,1999-2019,301,294,124,124,0,0,124,3 (3ct 0st),0.421,1999,2019,WI
391,V Kohli ,2008-2019,242,240,124,124,0,0,124,3 (3ct 0st),0.516,2008,2019,INDIA
392,RW Marsh ,1971-1984,92,92,124,120,4,120,0,5 (5ct 0st),1.347,1971,1984,AUS
393,ST Jayasuriya ,1989-2011,445,441,123,123,0,0,123,3 (3ct 0st),0.278,1989,2011,SL
394,CL Hooper ,1987-2003,227,225,120,120,0,0,120,4 (4ct 0st),0.5329999999999999,1987,2003,WI
395,BC Lara ,1990-2007,299,296,120,120,0,0,120,3 (3ct 0st),0.405,1990,2007,WI
396,L Ronchi ,2008-2017,85,83,117,105,12,105,0,4 (4ct 0st),1.409,2008,2017,AUS
397,MS Wade ,2012-2017,94,94,117,108,9,108,0,5 (5ct 0st),1.244,2012,2017,AUS
398,Inzamam-ul-Haq ,1991-2007,378,373,113,113,0,0,113,3 (3ct 0st),0.302,1991,2007,PAK
399,SR Waugh ,1986-2002,325,324,111,111,0,0,111,3 (3ct 0st),0.342,1986,2002,AUS
400,KC Sangakkara ,2000-2015,404,397,501,402,99,383,19,5 (4ct 1st),1.261,2000,2015,SL
401,AC Gilchrist ,1996-2008,287,286,472,417,55,417,0,6 (6ct 0st),1.65,1996,2008,AUS
402,MS Dhoni ,2004-2019,350,345,444,321,123,321,0,6 (5ct 1st),1.286,2004,2019,INDIA
403,MV Boucher ,1998-2011,295,291,425,403,22,402,1,6 (6ct 0st),1.46,1998,2011,SA
404,Moin Khan ,1990-2004,219,217,287,214,73,214,0,5 (5ct 0st),1.3219999999999998,1990,2004,PAK
405,BB McCullum ,2002-2016,260,257,277,262,15,227,35,5 (5ct 0st),1.077,2002,2016,NZ
406,IA Healy ,1988-1997,168,168,233,194,39,194,0,4 (4ct 0st),1.386,1988,1997,AUS
407,Mushfiqur Rahim ,2006-2019,216,215,225,181,44,179,2,5 (5ct 0st),1.046,2006,2019,BDESH
408,Rashid Latif ,1992-2003,166,164,220,182,38,182,0,5 (5ct 0st),1.341,1992,2003,PAK
409,DPMD Jayawardene ,1998-2015,448,443,218,218,0,0,218,4 (4ct 0st),0.492,1998,2015,SL
410,R Dravid ,1996-2011,344,341,210,196,14,72,124,4 (4ct 0st),0.615,1996,2011,INDIA
411,RS Kaluwitharana ,1990-2004,189,188,207,132,75,131,1,5 (4ct 1st),1.101,1990,2004,SL
412,PJL Dujon ,1981-1991,169,168,204,183,21,183,0,4 (4ct 0st),1.214,1981,1991,WI
413,JC Buttler ,2012-2019,142,138,202,171,31,171,0,6 (6ct 0st),1.463,2012,2019,ENG
414,RD Jacobs ,1996-2004,147,145,189,160,29,160,0,6 (5ct 1st),1.3030000000000002,1996,2004,WI
415,Kamran Akmal ,2002-2017,157,154,188,157,31,156,1,5 (4ct 1st),1.22,2002,2017,PAK
416,D Ramdin ,2005-2016,139,137,188,181,7,181,0,5 (5ct 0st),1.372,2005,2016,WI
417,AB de Villiers ,2005-2018,228,223,181,176,5,93,83,5 (5ct 0st),0.8109999999999999,2005,2018,SA
418,BJ Haddin ,2001-2015,126,124,181,170,11,170,0,5 (5ct 0st),1.459,2001,2015,AUS
419,AJ Stewart ,1989-2003,170,169,174,159,15,148,11,6 (6ct 0st),1.029,1989,2003,ENG
420,A Flower ,1992-2003,213,212,173,141,32,133,8,5 (5ct 0st),0.816,1992,2003,ZIM
421,Q de Kock ,2013-2019,115,111,166,158,8,158,0,6 (5ct 1st),1.495,2013,2019,SA
422,DJ Richardson ,1991-1998,122,121,165,148,17,148,0,5 (5ct 0st),1.3630000000000002,1991,1998,SA
423,RT Ponting ,1995-2012,375,372,160,160,0,0,160,3 (3ct 0st),0.43,1995,2012,AUS
424,M Azharuddin ,1985-2000,334,332,156,156,0,0,156,4 (4ct 0st),0.469,1985,2000,INDIA
425,NR Mongia ,1994-2000,140,139,154,110,44,110,0,5 (4ct 1st),1.107,1994,2000,INDIA
426,BRM Taylor ,2004-2019,193,193,154,125,29,96,29,5 (5ct 0st),0.797,2004,2019,ZIM
427,T Taibu ,2001-2012,150,150,147,114,33,112,2,4 (4ct 0st),0.98,2001,2012,ZIM
428,AC Parore ,1992-2002,179,178,141,116,25,111,5,5 (3ct 2st),0.792,1992,2002,NZ
429,Sarfaraz Ahmed ,2007-2019,116,114,140,116,24,116,0,6 (6ct 0st),1.228,2007,2019,PAK
430,SR Tendulkar ,1989-2012,463,456,140,140,0,0,140,4 (4ct 0st),0.307,1989,2012,INDIA
431,LRPL Taylor ,2006-2019,228,224,137,137,0,0,137,4 (4ct 0st),0.611,2006,2019,NZ
432,Younis Khan ,2000-2015,265,260,135,135,0,5,130,4 (4ct 0st),0.519,2000,2015,PAK
433,SP Fleming ,1994-2007,280,276,133,133,0,0,133,4 (4ct 0st),0.481,1994,2007,NZ
434,JH Kallis ,1996-2014,328,324,131,131,0,0,131,3 (3ct 0st),0.4039999999999999,1996,2014,SA
435,M Muralitharan ,1993-2011,350,347,130,130,0,0,130,3 (3ct 0st),0.374,1993,2011,SL
436,AR Border ,1979-1994,273,270,127,127,0,0,127,3 (3ct 0st),0.47,1979,1994,AUS
437,Shahid Afridi ,1996-2015,398,392,127,127,0,0,127,2 (2ct 0st),0.3229999999999999,1996,2015,PAK
438,Khaled Mashud ,1995-2006,126,126,126,91,35,91,0,5 (3ct 2st),1.0,1995,2006,BDESH
439,TM Dilshan ,1999-2016,330,325,124,123,1,5,118,3 (3ct 0st),0.381,1999,2016,SL
440,CH Gayle ,1999-2019,301,294,124,124,0,0,124,3 (3ct 0st),0.421,1999,2019,WI
441,V Kohli ,2008-2019,242,240,124,124,0,0,124,3 (3ct 0st),0.516,2008,2019,INDIA
442,RW Marsh ,1971-1984,92,92,124,120,4,120,0,5 (5ct 0st),1.347,1971,1984,AUS
443,ST Jayasuriya ,1989-2011,445,441,123,123,0,0,123,3 (3ct 0st),0.278,1989,2011,SL
444,CL Hooper ,1987-2003,227,225,120,120,0,0,120,4 (4ct 0st),0.5329999999999999,1987,2003,WI
445,BC Lara ,1990-2007,299,296,120,120,0,0,120,3 (3ct 0st),0.405,1990,2007,WI
446,L Ronchi ,2008-2017,85,83,117,105,12,105,0,4 (4ct 0st),1.409,2008,2017,AUS
447,MS Wade ,2012-2017,94,94,117,108,9,108,0,5 (5ct 0st),1.244,2012,2017,AUS
448,Inzamam-ul-Haq ,1991-2007,378,373,113,113,0,0,113,3 (3ct 0st),0.302,1991,2007,PAK
449,SR Waugh ,1986-2002,325,324,111,111,0,0,111,3 (3ct 0st),0.342,1986,2002,AUS
450,KC Sangakkara ,2000-2015,404,397,501,402,99,383,19,5 (4ct 1st),1.261,2000,2015,SL
451,AC Gilchrist ,1996-2008,287,286,472,417,55,417,0,6 (6ct 0st),1.65,1996,2008,AUS
452,MS Dhoni ,2004-2019,350,345,444,321,123,321,0,6 (5ct 1st),1.286,2004,2019,INDIA
453,MV Boucher ,1998-2011,295,291,425,403,22,402,1,6 (6ct 0st),1.46,1998,2011,SA
454,Moin Khan ,1990-2004,219,217,287,214,73,214,0,5 (5ct 0st),1.3219999999999998,1990,2004,PAK
455,BB McCullum ,2002-2016,260,257,277,262,15,227,35,5 (5ct 0st),1.077,2002,2016,NZ
456,IA Healy ,1988-1997,168,168,233,194,39,194,0,4 (4ct 0st),1.386,1988,1997,AUS
457,Mushfiqur Rahim ,2006-2019,216,215,225,181,44,179,2,5 (5ct 0st),1.046,2006,2019,BDESH
458,Rashid Latif ,1992-2003,166,164,220,182,38,182,0,5 (5ct 0st),1.341,1992,2003,PAK
459,DPMD Jayawardene ,1998-2015,448,443,218,218,0,0,218,4 (4ct 0st),0.492,1998,2015,SL
460,R Dravid ,1996-2011,344,341,210,196,14,72,124,4 (4ct 0st),0.615,1996,2011,INDIA
461,RS Kaluwitharana ,1990-2004,189,188,207,132,75,131,1,5 (4ct 1st),1.101,1990,2004,SL
462,PJL Dujon ,1981-1991,169,168,204,183,21,183,0,4 (4ct 0st),1.214,1981,1991,WI
463,JC Buttler ,2012-2019,142,138,202,171,31,171,0,6 (6ct 0st),1.463,2012,2019,ENG
464,RD Jacobs ,1996-2004,147,145,189,160,29,160,0,6 (5ct 1st),1.3030000000000002,1996,2004,WI
465,Kamran Akmal ,2002-2017,157,154,188,157,31,156,1,5 (4ct 1st),1.22,2002,2017,PAK
466,D Ramdin ,2005-2016,139,137,188,181,7,181,0,5 (5ct 0st),1.372,2005,2016,WI
467,AB de Villiers ,2005-2018,228,223,181,176,5,93,83,5 (5ct 0st),0.8109999999999999,2005,2018,SA
468,BJ Haddin ,2001-2015,126,124,181,170,11,170,0,5 (5ct 0st),1.459,2001,2015,AUS
469,AJ Stewart ,1989-2003,170,169,174,159,15,148,11,6 (6ct 0st),1.029,1989,2003,ENG
470,A Flower ,1992-2003,213,212,173,141,32,133,8,5 (5ct 0st),0.816,1992,2003,ZIM
471,Q de Kock ,2013-2019,115,111,166,158,8,158,0,6 (5ct 1st),1.495,2013,2019,SA
472,DJ Richardson ,1991-1998,122,121,165,148,17,148,0,5 (5ct 0st),1.3630000000000002,1991,1998,SA
473,RT Ponting ,1995-2012,375,372,160,160,0,0,160,3 (3ct 0st),0.43,1995,2012,AUS
474,M Azharuddin ,1985-2000,334,332,156,156,0,0,156,4 (4ct 0st),0.469,1985,2000,INDIA
475,NR Mongia ,1994-2000,140,139,154,110,44,110,0,5 (4ct 1st),1.107,1994,2000,INDIA
476,BRM Taylor ,2004-2019,193,193,154,125,29,96,29,5 (5ct 0st),0.797,2004,2019,ZIM
477,T Taibu ,2001-2012,150,150,147,114,33,112,2,4 (4ct 0st),0.98,2001,2012,ZIM
478,AC Parore ,1992-2002,179,178,141,116,25,111,5,5 (3ct 2st),0.792,1992,2002,NZ
479,Sarfaraz Ahmed ,2007-2019,116,114,140,116,24,116,0,6 (6ct 0st),1.228,2007,2019,PAK
480,SR Tendulkar ,1989-2012,463,456,140,140,0,0,140,4 (4ct 0st),0.307,1989,2012,INDIA
481,LRPL Taylor ,2006-2019,228,224,137,137,0,0,137,4 (4ct 0st),0.611,2006,2019,NZ
482,Younis Khan ,2000-2015,265,260,135,135,0,5,130,4 (4ct 0st),0.519,2000,2015,PAK
483,SP Fleming ,1994-2007,280,276,133,133,0,0,133,4 (4ct 0st),0.481,1994,2007,NZ
484,JH Kallis ,1996-2014,328,324,131,131,0,0,131,3 (3ct 0st),0.4039999999999999,1996,2014,SA
485,M Muralitharan ,1993-2011,350,347,130,130,0,0,130,3 (3ct 0st),0.374,1993,2011,SL
486,AR Border ,1979-1994,273,270,127,127,0,0,127,3 (3ct 0st),0.47,1979,1994,AUS
487,Shahid Afridi ,1996-2015,398,392,127,127,0,0,127,2 (2ct 0st),0.3229999999999999,1996,2015,PAK
488,Khaled Mashud ,1995-2006,126,126,126,91,35,91,0,5 (3ct 2st),1.0,1995,2006,BDESH
489,TM Dilshan ,1999-2016,330,325,124,123,1,5,118,3 (3ct 0st),0.381,1999,2016,SL
490,CH Gayle ,1999-2019,301,294,124,124,0,0,124,3 (3ct 0st),0.421,1999,2019,WI
491,V Kohli ,2008-2019,242,240,124,124,0,0,124,3 (3ct 0st),0.516,2008,2019,INDIA
492,RW Marsh ,1971-1984,92,92,124,120,4,120,0,5 (5ct 0st),1.347,1971,1984,AUS
493,ST Jayasuriya ,1989-2011,445,441,123,123,0,0,123,3 (3ct 0st),0.278,1989,2011,SL
494,CL Hooper ,1987-2003,227,225,120,120,0,0,120,4 (4ct 0st),0.5329999999999999,1987,2003,WI
495,BC Lara ,1990-2007,299,296,120,120,0,0,120,3 (3ct 0st),0.405,1990,2007,WI
496,L Ronchi ,2008-2017,85,83,117,105,12,105,0,4 (4ct 0st),1.409,2008,2017,AUS
497,MS Wade ,2012-2017,94,94,117,108,9,108,0,5 (5ct 0st),1.244,2012,2017,AUS
498,Inzamam-ul-Haq ,1991-2007,378,373,113,113,0,0,113,3 (3ct 0st),0.302,1991,2007,PAK
499,SR Waugh ,1986-2002,325,324,111,111,0,0,111,3 (3ct 0st),0.342,1986,2002,AUS
500,KC Sangakkara ,2000-2015,404,397,501,402,99,383,19,5 (4ct 1st),1.261,2000,2015,SL
501,AC Gilchrist ,1996-2008,287,286,472,417,55,417,0,6 (6ct 0st),1.65,1996,2008,AUS
502,MS Dhoni ,2004-2019,350,345,444,321,123,321,0,6 (5ct 1st),1.286,2004,2019,INDIA
503,MV Boucher ,1998-2011,295,291,425,403,22,402,1,6 (6ct 0st),1.46,1998,2011,SA
504,Moin Khan ,1990-2004,219,217,287,214,73,214,0,5 (5ct 0st),1.3219999999999998,1990,2004,PAK
505,BB McCullum ,2002-2016,260,257,277,262,15,227,35,5 (5ct 0st),1.077,2002,2016,NZ
506,IA Healy ,1988-1997,168,168,233,194,39,194,0,4 (4ct 0st),1.386,1988,1997,AUS
507,Mushfiqur Rahim ,2006-2019,216,215,225,181,44,179,2,5 (5ct 0st),1.046,2006,2019,BDESH
508,Rashid Latif ,1992-2003,166,164,220,182,38,182,0,5 (5ct 0st),1.341,1992,2003,PAK
509,DPMD Jayawardene ,1998-2015,448,443,218,218,0,0,218,4 (4ct 0st),0.492,1998,2015,SL
510,R Dravid ,1996-2011,344,341,210,196,14,72,124,4 (4ct 0st),0.615,1996,2011,INDIA
511,RS Kaluwitharana ,1990-2004,189,188,207,132,75,131,1,5 (4ct 1st),1.101,1990,2004,SL
512,PJL Dujon ,1981-1991,169,168,204,183,21,183,0,4 (4ct 0st),1.214,1981,1991,WI
513,JC Buttler ,2012-2019,142,138,202,171,31,171,0,6 (6ct 0st),1.463,2012,2019,ENG
514,RD Jacobs ,1996-2004,147,145,189,160,29,160,0,6 (5ct 1st),1.3030000000000002,1996,2004,WI
515,Kamran Akmal ,2002-2017,157,154,188,157,31,156,1,5 (4ct 1st),1.22,2002,2017,PAK
516,D Ramdin ,2005-2016,139,137,188,181,7,181,0,5 (5ct 0st),1.372,2005,2016,WI
517,AB de Villiers ,2005-2018,228,223,181,176,5,93,83,5 (5ct 0st),0.8109999999999999,2005,2018,SA
518,BJ Haddin ,2001-2015,126,124,181,170,11,170,0,5 (5ct 0st),1.459,2001,2015,AUS
519,AJ Stewart ,1989-2003,170,169,174,159,15,148,11,6 (6ct 0st),1.029,1989,2003,ENG
520,A Flower ,1992-2003,213,212,173,141,32,133,8,5 (5ct 0st),0.816,1992,2003,ZIM
521,Q de Kock ,2013-2019,115,111,166,158,8,158,0,6 (5ct 1st),1.495,2013,2019,SA
522,DJ Richardson ,1991-1998,122,121,165,148,17,148,0,5 (5ct 0st),1.3630000000000002,1991,1998,SA
523,RT Ponting ,1995-2012,375,372,160,160,0,0,160,3 (3ct 0st),0.43,1995,2012,AUS
524,M Azharuddin ,1985-2000,334,332,156,156,0,0,156,4 (4ct 0st),0.469,1985,2000,INDIA
525,NR Mongia ,1994-2000,140,139,154,110,44,110,0,5 (4ct 1st),1.107,1994,2000,INDIA
526,BRM Taylor ,2004-2019,193,193,154,125,29,96,29,5 (5ct 0st),0.797,2004,2019,ZIM
527,T Taibu ,2001-2012,150,150,147,114,33,112,2,4 (4ct 0st),0.98,2001,2012,ZIM
528,AC Parore ,1992-2002,179,178,141,116,25,111,5,5 (3ct 2st),0.792,1992,2002,NZ
529,Sarfaraz Ahmed ,2007-2019,116,114,140,116,24,116,0,6 (6ct 0st),1.228,2007,2019,PAK
530,SR Tendulkar ,1989-2012,463,456,140,140,0,0,140,4 (4ct 0st),0.307,1989,2012,INDIA
531,LRPL Taylor ,2006-2019,228,224,137,137,0,0,137,4 (4ct 0st),0.611,2006,2019,NZ
532,Younis Khan ,2000-2015,265,260,135,135,0,5,130,4 (4ct 0st),0.519,2000,2015,PAK
533,SP Fleming ,1994-2007,280,276,133,133,0,0,133,4 (4ct 0st),0.481,1994,2007,NZ
534,JH Kallis ,1996-2014,328,324,131,131,0,0,131,3 (3ct 0st),0.4039999999999999,1996,2014,SA
535,M Muralitharan ,1993-2011,350,347,130,130,0,0,130,3 (3ct 0st),0.374,1993,2011,SL
536,AR Border ,1979-1994,273,270,127,127,0,0,127,3 (3ct 0st),0.47,1979,1994,AUS
537,Shahid Afridi ,1996-2015,398,392,127,127,0,0,127,2 (2ct 0st),0.3229999999999999,1996,2015,PAK
538,Khaled Mashud ,1995-2006,126,126,126,91,35,91,0,5 (3ct 2st),1.0,1995,2006,BDESH
539,TM Dilshan ,1999-2016,330,325,124,123,1,5,118,3 (3ct 0st),0.381,1999,2016,SL
540,CH Gayle ,1999-2019,301,294,124,124,0,0,124,3 (3ct 0st),0.421,1999,2019,WI
541,V Kohli ,2008-2019,242,240,124,124,0,0,124,3 (3ct 0st),0.516,2008,2019,INDIA
542,RW Marsh ,1971-1984,92,92,124,120,4,120,0,5 (5ct 0st),1.347,1971,1984,AUS
543,ST Jayasuriya ,1989-2011,445,441,123,123,0,0,123,3 (3ct 0st),0.278,1989,2011,SL
544,CL Hooper ,1987-2003,227,225,120,120,0,0,120,4 (4ct 0st),0.5329999999999999,1987,2003,WI
545,BC Lara ,1990-2007,299,296,120,120,0,0,120,3 (3ct 0st),0.405,1990,2007,WI
546,L Ronchi ,2008-2017,85,83,117,105,12,105,0,4 (4ct 0st),1.409,2008,2017,AUS
547,MS Wade ,2012-2017,94,94,117,108,9,108,0,5 (5ct 0st),1.244,2012,2017,AUS
548,Inzamam-ul-Haq ,1991-2007,378,373,113,113,0,0,113,3 (3ct 0st),0.302,1991,2007,PAK
549,SR Waugh ,1986-2002,325,324,111,111,0,0,111,3 (3ct 0st),0.342,1986,2002,AUS
550,KC Sangakkara ,2000-2015,404,397,501,402,99,383,19,5 (4ct 1st),1.261,2000,2015,SL
551,AC Gilchrist ,1996-2008,287,286,472,417,55,417,0,6 (6ct 0st),1.65,1996,2008,AUS
552,MS Dhoni ,2004-2019,350,345,444,321,123,321,0,6 (5ct 1st),1.286,2004,2019,INDIA
553,MV Boucher ,1998-2011,295,291,425,403,22,402,1,6 (6ct 0st),1.46,1998,2011,SA
554,Moin Khan ,1990-2004,219,217,287,214,73,214,0,5 (5ct 0st),1.3219999999999998,1990,2004,PAK
555,BB McCullum ,2002-2016,260,257,277,262,15,227,35,5 (5ct 0st),1.077,2002,2016,NZ
556,IA Healy ,1988-1997,168,168,233,194,39,194,0,4 (4ct 0st),1.386,1988,1997,AUS
557,Mushfiqur Rahim ,2006-2019,216,215,225,181,44,179,2,5 (5ct 0st),1.046,2006,2019,BDESH
558,Rashid Latif ,1992-2003,166,164,220,182,38,182,0,5 (5ct 0st),1.341,1992,2003,PAK
559,DPMD Jayawardene ,1998-2015,448,443,218,218,0,0,218,4 (4ct 0st),0.492,1998,2015,SL
560,R Dravid ,1996-2011,344,341,210,196,14,72,124,4 (4ct 0st),0.615,1996,2011,INDIA
561,RS Kaluwitharana ,1990-2004,189,188,207,132,75,131,1,5 (4ct 1st),1.101,1990,2004,SL
562,PJL Dujon ,1981-1991,169,168,204,183,21,183,0,4 (4ct 0st),1.214,1981,1991,WI
563,JC Buttler ,2012-2019,142,138,202,171,31,171,0,6 (6ct 0st),1.463,2012,2019,ENG
564,RD Jacobs ,1996-2004,147,145,189,160,29,160,0,6 (5ct 1st),1.3030000000000002,1996,2004,WI
565,Kamran Akmal ,2002-2017,157,154,188,157,31,156,1,5 (4ct 1st),1.22,2002,2017,PAK
566,D Ramdin ,2005-2016,139,137,188,181,7,181,0,5 (5ct 0st),1.372,2005,2016,WI
567,AB de Villiers ,2005-2018,228,223,181,176,5,93,83,5 (5ct 0st),0.8109999999999999,2005,2018,SA
568,BJ Haddin ,2001-2015,126,124,181,170,11,170,0,5 (5ct 0st),1.459,2001,2015,AUS
569,AJ Stewart ,1989-2003,170,169,174,159,15,148,11,6 (6ct 0st),1.029,1989,2003,ENG
570,A Flower ,1992-2003,213,212,173,141,32,133,8,5 (5ct 0st),0.816,1992,2003,ZIM
571,Q de Kock ,2013-2019,115,111,166,158,8,158,0,6 (5ct 1st),1.495,2013,2019,SA
572,DJ Richardson ,1991-1998,122,121,165,148,17,148,0,5 (5ct 0st),1.3630000000000002,1991,1998,SA
573,RT Ponting ,1995-2012,375,372,160,160,0,0,160,3 (3ct 0st),0.43,1995,2012,AUS
574,M Azharuddin ,1985-2000,334,332,156,156,0,0,156,4 (4ct 0st),0.469,1985,2000,INDIA
575,NR Mongia ,1994-2000,140,139,154,110,44,110,0,5 (4ct 1st),1.107,1994,2000,INDIA
576,BRM Taylor ,2004-2019,193,193,154,125,29,96,29,5 (5ct 0st),0.797,2004,2019,ZIM
577,T Taibu ,2001-2012,150,150,147,114,33,112,2,4 (4ct 0st),0.98,2001,2012,ZIM
578,AC Parore ,1992-2002,179,178,141,116,25,111,5,5 (3ct 2st),0.792,1992,2002,NZ
579,Sarfaraz Ahmed ,2007-2019,116,114,140,116,24,116,0,6 (6ct 0st),1.228,2007,2019,PAK
580,SR Tendulkar ,1989-2012,463,456,140,140,0,0,140,4 (4ct 0st),0.307,1989,2012,INDIA
581,LRPL Taylor ,2006-2019,228,224,137,137,0,0,137,4 (4ct 0st),0.611,2006,2019,NZ
582,Younis Khan ,2000-2015,265,260,135,135,0,5,130,4 (4ct 0st),0.519,2000,2015,PAK
583,SP Fleming ,1994-2007,280,276,133,133,0,0,133,4 (4ct 0st),0.481,1994,2007,NZ
584,JH Kallis ,1996-2014,328,324,131,131,0,0,131,3 (3ct 0st),0.4039999999999999,1996,2014,SA
585,M Muralitharan ,1993-2011,350,347,130,130,0,0,130,3 (3ct 0st),0.374,1993,2011,SL
586,AR Border ,1979-1994,273,270,127,127,0,0,127,3 (3ct 0st),0.47,1979,1994,AUS
587,Shahid Afridi ,1996-2015,398,392,127,127,0,0,127,2 (2ct 0st),0.3229999999999999,1996,2015,PAK
588,Khaled Mashud ,1995-2006,126,126,126,91,35,91,0,5 (3ct 2st),1.0,1995,2006,BDESH
589,TM Dilshan ,1999-2016,330,325,124,123,1,5,118,3 (3ct 0st),0.381,1999,2016,SL
590,CH Gayle ,1999-2019,301,294,124,124,0,0,124,3 (3ct 0st),0.421,1999,2019,WI
591,V Kohli ,2008-2019,242,240,124,124,0,0,124,3 (3ct 0st),0.516,2008,2019,INDIA
592,RW Marsh ,1971-1984,92,92,124,120,4,120,0,5 (5ct 0st),1.347,1971,1984,AUS
593,ST Jayasuriya ,1989-2011,445,441,123,123,0,0,123,3 (3ct 0st),0.278,1989,2011,SL
594,CL Hooper ,1987-2003,227,225,120,120,0,0,120,4 (4ct 0st),0.5329999999999999,1987,2003,WI
595,BC Lara ,1990-2007,299,296,120,120,0,0,120,3 (3ct 0st),0.405,1990,2007,WI
596,L Ronchi ,2008-2017,85,83,117,105,12,105,0,4 (4ct 0st),1.409,2008,2017,AUS
597,MS Wade ,2012-2017,94,94,117,108,9,108,0,5 (5ct 0st),1.244,2012,2017,AUS
598,Inzamam-ul-Haq ,1991-2007,378,373,113,113,0,0,113,3 (3ct 0st),0.302,1991,2007,PAK
599,SR Waugh ,1986-2002,325,324,111,111,0,0,111,3 (3ct 0st),0.342,1986,2002,AUS
600,KC Sangakkara ,2000-2015,404,397,501,402,99,383,19,5 (4ct 1st),1.261,2000,2015,SL
601,AC Gilchrist ,1996-2008,287,286,472,417,55,417,0,6 (6ct 0st),1.65,1996,2008,AUS
602,MS Dhoni ,2004-2019,350,345,444,321,123,321,0,6 (5ct 1st),1.286,2004,2019,INDIA
603,MV Boucher ,1998-2011,295,291,425,403,22,402,1,6 (6ct 0st),1.46,1998,2011,SA
604,Moin Khan ,1990-2004,219,217,287,214,73,214,0,5 (5ct 0st),1.3219999999999998,1990,2004,PAK
605,BB McCullum ,2002-2016,260,257,277,262,15,227,35,5 (5ct 0st),1.077,2002,2016,NZ
606,IA Healy ,1988-1997,168,168,233,194,39,194,0,4 (4ct 0st),1.386,1988,1997,AUS
607,Mushfiqur Rahim ,2006-2019,216,215,225,181,44,179,2,5 (5ct 0st),1.046,2006,2019,BDESH
608,Rashid Latif ,1992-2003,166,164,220,182,38,182,0,5 (5ct 0st),1.341,1992,2003,PAK
609,DPMD Jayawardene ,1998-2015,448,443,218,218,0,0,218,4 (4ct 0st),0.492,1998,2015,SL
610,R Dravid ,1996-2011,344,341,210,196,14,72,124,4 (4ct 0st),0.615,1996,2011,INDIA
611,RS Kaluwitharana ,1990-2004,189,188,207,132,75,131,1,5 (4ct 1st),1.101,1990,2004,SL
612,PJL Dujon ,1981-1991,169,168,204,183,21,183,0,4 (4ct 0st),1.214,1981,1991,WI
613,JC Buttler ,2012-2019,142,138,202,171,31,171,0,6 (6ct 0st),1.463,2012,2019,ENG
614,RD Jacobs ,1996-2004,147,145,189,160,29,160,0,6 (5ct 1st),1.3030000000000002,1996,2004,WI
615,Kamran Akmal ,2002-2017,157,154,188,157,31,156,1,5 (4ct 1st),1.22,2002,2017,PAK
616,D Ramdin ,2005-2016,139,137,188,181,7,181,0,5 (5ct 0st),1.372,2005,2016,WI
617,AB de Villiers ,2005-2018,228,223,181,176,5,93,83,5 (5ct 0st),0.8109999999999999,2005,2018,SA
618,BJ Haddin ,2001-2015,126,124,181,170,11,170,0,5 (5ct 0st),1.459,2001,2015,AUS
619,AJ Stewart ,1989-2003,170,169,174,159,15,148,11,6 (6ct 0st),1.029,1989,2003,ENG
620,A Flower ,1992-2003,213,212,173,141,32,133,8,5 (5ct 0st),0.816,1992,2003,ZIM
621,Q de Kock ,2013-2019,115,111,166,158,8,158,0,6 (5ct 1st),1.495,2013,2019,SA
622,DJ Richardson ,1991-1998,122,121,165,148,17,148,0,5 (5ct 0st),1.3630000000000002,1991,1998,SA
623,RT Ponting ,1995-2012,375,372,160,160,0,0,160,3 (3ct 0st),0.43,1995,2012,AUS
624,M Azharuddin ,1985-2000,334,332,156,156,0,0,156,4 (4ct 0st),0.469,1985,2000,INDIA
625,NR Mongia ,1994-2000,140,139,154,110,44,110,0,5 (4ct 1st),1.107,1994,2000,INDIA
626,BRM Taylor ,2004-2019,193,193,154,125,29,96,29,5 (5ct 0st),0.797,2004,2019,ZIM
627,T Taibu ,2001-2012,150,150,147,114,33,112,2,4 (4ct 0st),0.98,2001,2012,ZIM
628,AC Parore ,1992-2002,179,178,141,116,25,111,5,5 (3ct 2st),0.792,1992,2002,NZ
629,Sarfaraz Ahmed ,2007-2019,116,114,140,116,24,116,0,6 (6ct 0st),1.228,2007,2019,PAK
630,SR Tendulkar ,1989-2012,463,456,140,140,0,0,140,4 (4ct 0st),0.307,1989,2012,INDIA
631,LRPL Taylor ,2006-2019,228,224,137,137,0,0,137,4 (4ct 0st),0.611,2006,2019,NZ
632,Younis Khan ,2000-2015,265,260,135,135,0,5,130,4 (4ct 0st),0.519,2000,2015,PAK
633,SP Fleming ,1994-2007,280,276,133,133,0,0,133,4 (4ct 0st),0.481,1994,2007,NZ
634,JH Kallis ,1996-2014,328,324,131,131,0,0,131,3 (3ct 0st),0.4039999999999999,1996,2014,SA
635,M Muralitharan ,1993-2011,350,347,130,130,0,0,130,3 (3ct 0st),0.374,1993,2011,SL
636,AR Border ,1979-1994,273,270,127,127,0,0,127,3 (3ct 0st),0.47,1979,1994,AUS
637,Shahid Afridi ,1996-2015,398,392,127,127,0,0,127,2 (2ct 0st),0.3229999999999999,1996,2015,PAK
638,Khaled Mashud ,1995-2006,126,126,126,91,35,91,0,5 (3ct 2st),1.0,1995,2006,BDESH
639,TM Dilshan ,1999-2016,330,325,124,123,1,5,118,3 (3ct 0st),0.381,1999,2016,SL
640,CH Gayle ,1999-2019,301,294,124,124,0,0,124,3 (3ct 0st),0.421,1999,2019,WI
641,V Kohli ,2008-2019,242,240,124,124,0,0,124,3 (3ct 0st),0.516,2008,2019,INDIA
642,RW Marsh ,1971-1984,92,92,124,120,4,120,0,5 (5ct 0st),1.347,1971,1984,AUS
643,ST Jayasuriya ,1989-2011,445,441,123,123,0,0,123,3 (3ct 0st),0.278,1989,2011,SL
644,CL Hooper ,1987-2003,227,225,120,120,0,0,120,4 (4ct 0st),0.5329999999999999,1987,2003,WI
645,BC Lara ,1990-2007,299,296,120,120,0,0,120,3 (3ct 0st),0.405,1990,2007,WI
646,L Ronchi ,2008-2017,85,83,117,105,12,105,0,4 (4ct 0st),1.409,2008,2017,AUS
647,MS Wade ,2012-2017,94,94,117,108,9,108,0,5 (5ct 0st),1.244,2012,2017,AUS
648,Inzamam-ul-Haq ,1991-2007,378,373,113,113,0,0,113,3 (3ct 0st),0.302,1991,2007,PAK
649,SR Waugh ,1986-2002,325,324,111,111,0,0,111,3 (3ct 0st),0.342,1986,2002,AUS
650,KC Sangakkara ,2000-2015,404,397,501,402,99,383,19,5 (4ct 1st),1.261,2000,2015,SL
651,AC Gilchrist ,1996-2008,287,286,472,417,55,417,0,6 (6ct 0st),1.65,1996,2008,AUS
652,MS Dhoni ,2004-2019,350,345,444,321,123,321,0,6 (5ct 1st),1.286,2004,2019,INDIA
653,MV Boucher ,1998-2011,295,291,425,403,22,402,1,6 (6ct 0st),1.46,1998,2011,SA
654,Moin Khan ,1990-2004,219,217,287,214,73,214,0,5 (5ct 0st),1.3219999999999998,1990,2004,PAK
655,BB McCullum ,2002-2016,260,257,277,262,15,227,35,5 (5ct 0st),1.077,2002,2016,NZ
656,IA Healy ,1988-1997,168,168,233,194,39,194,0,4 (4ct 0st),1.386,1988,1997,AUS
657,Mushfiqur Rahim ,2006-2019,216,215,225,181,44,179,2,5 (5ct 0st),1.046,2006,2019,BDESH
658,Rashid Latif ,1992-2003,166,164,220,182,38,182,0,5 (5ct 0st),1.341,1992,2003,PAK
659,DPMD Jayawardene ,1998-2015,448,443,218,218,0,0,218,4 (4ct 0st),0.492,1998,2015,SL
660,R Dravid ,1996-2011,344,341,210,196,14,72,124,4 (4ct 0st),0.615,1996,2011,INDIA
661,RS Kaluwitharana ,1990-2004,189,188,207,132,75,131,1,5 (4ct 1st),1.101,1990,2004,SL
662,PJL Dujon ,1981-1991,169,168,204,183,21,183,0,4 (4ct 0st),1.214,1981,1991,WI
663,JC Buttler ,2012-2019,142,138,202,171,31,171,0,6 (6ct 0st),1.463,2012,2019,ENG
664,RD Jacobs ,1996-2004,147,145,189,160,29,160,0,6 (5ct 1st),1.3030000000000002,1996,2004,WI
665,Kamran Akmal ,2002-2017,157,154,188,157,31,156,1,5 (4ct 1st),1.22,2002,2017,PAK
666,D Ramdin ,2005-2016,139,137,188,181,7,181,0,5 (5ct 0st),1.372,2005,2016,WI
667,AB de Villiers ,2005-2018,228,223,181,176,5,93,83,5 (5ct 0st),0.8109999999999999,2005,2018,SA
668,BJ Haddin ,2001-2015,126,124,181,170,11,170,0,5 (5ct 0st),1.459,2001,2015,AUS
669,AJ Stewart ,1989-2003,170,169,174,159,15,148,11,6 (6ct 0st),1.029,1989,2003,ENG
670,A Flower ,1992-2003,213,212,173,141,32,133,8,5 (5ct 0st),0.816,1992,2003,ZIM
671,Q de Kock ,2013-2019,115,111,166,158,8,158,0,6 (5ct 1st),1.495,2013,2019,SA
672,DJ Richardson ,1991-1998,122,121,165,148,17,148,0,5 (5ct 0st),1.3630000000000002,1991,1998,SA
673,RT Ponting ,1995-2012,375,372,160,160,0,0,160,3 (3ct 0st),0.43,1995,2012,AUS
674,M Azharuddin ,1985-2000,334,332,156,156,0,0,156,4 (4ct 0st),0.469,1985,2000,INDIA
675,NR Mongia ,1994-2000,140,139,154,110,44,110,0,5 (4ct 1st),1.107,1994,2000,INDIA
676,BRM Taylor ,2004-2019,193,193,154,125,29,96,29,5 (5ct 0st),0.797,2004,2019,ZIM
677,T Taibu ,2001-2012,150,150,147,114,33,112,2,4 (4ct 0st),0.98,2001,2012,ZIM
678,AC Parore ,1992-2002,179,178,141,116,25,111,5,5 (3ct 2st),0.792,1992,2002,NZ
679,Sarfaraz Ahmed ,2007-2019,116,114,140,116,24,116,0,6 (6ct 0st),1.228,2007,2019,PAK
680,SR Tendulkar ,1989-2012,463,456,140,140,0,0,140,4 (4ct 0st),0.307,1989,2012,INDIA
681,LRPL Taylor ,2006-2019,228,224,137,137,0,0,137,4 (4ct 0st),0.611,2006,2019,NZ
682,Younis Khan ,2000-2015,265,260,135,135,0,5,130,4 (4ct 0st),0.519,2000,2015,PAK
683,SP Fleming ,1994-2007,280,276,133,133,0,0,133,4 (4ct 0st),0.481,1994,2007,NZ
684,JH Kallis ,1996-2014,328,324,131,131,0,0,131,3 (3ct 0st),0.4039999999999999,1996,2014,SA
685,M Muralitharan ,1993-2011,350,347,130,130,0,0,130,3 (3ct 0st),0.374,1993,2011,SL
686,AR Border ,1979-1994,273,270,127,127,0,0,127,3 (3ct 0st),0.47,1979,1994,AUS
687,Shahid Afridi ,1996-2015,398,392,127,127,0,0,127,2 (2ct 0st),0.3229999999999999,1996,2015,PAK
688,Khaled Mashud ,1995-2006,126,126,126,91,35,91,0,5 (3ct 2st),1.0,1995,2006,BDESH
689,TM Dilshan ,1999-2016,330,325,124,123,1,5,118,3 (3ct 0st),0.381,1999,2016,SL
690,CH Gayle ,1999-2019,301,294,124,124,0,0,124,3 (3ct 0st),0.421,1999,2019,WI
691,V Kohli ,2008-2019,242,240,124,124,0,0,124,3 (3ct 0st),0.516,2008,2019,INDIA
692,RW Marsh ,1971-1984,92,92,124,120,4,120,0,5 (5ct 0st),1.347,1971,1984,AUS
693,ST Jayasuriya ,1989-2011,445,441,123,123,0,0,123,3 (3ct 0st),0.278,1989,2011,SL
694,CL Hooper ,1987-2003,227,225,120,120,0,0,120,4 (4ct 0st),0.5329999999999999,1987,2003,WI
695,BC Lara ,1990-2007,299,296,120,120,0,0,120,3 (3ct 0st),0.405,1990,2007,WI
696,L Ronchi ,2008-2017,85,83,117,105,12,105,0,4 (4ct 0st),1.409,2008,2017,AUS
697,MS Wade ,2012-2017,94,94,117,108,9,108,0,5 (5ct 0st),1.244,2012,2017,AUS
698,Inzamam-ul-Haq ,1991-2007,378,373,113,113,0,0,113,3 (3ct 0st),0.302,1991,2007,PAK
699,SR Waugh ,1986-2002,325,324,111,111,0,0,111,3 (3ct 0st),0.342,1986,2002,AUS
700,KC Sangakkara ,2000-2015,404,397,501,402,99,383,19,5 (4ct 1st),1.261,2000,2015,SL
701,AC Gilchrist ,1996-2008,287,286,472,417,55,417,0,6 (6ct 0st),1.65,1996,2008,AUS
702,MS Dhoni ,2004-2019,350,345,444,321,123,321,0,6 (5ct 1st),1.286,2004,2019,INDIA
703,MV Boucher ,1998-2011,295,291,425,403,22,402,1,6 (6ct 0st),1.46,1998,2011,SA
704,Moin Khan ,1990-2004,219,217,287,214,73,214,0,5 (5ct 0st),1.3219999999999998,1990,2004,PAK
705,BB McCullum ,2002-2016,260,257,277,262,15,227,35,5 (5ct 0st),1.077,2002,2016,NZ
706,IA Healy ,1988-1997,168,168,233,194,39,194,0,4 (4ct 0st),1.386,1988,1997,AUS
707,Mushfiqur Rahim ,2006-2019,216,215,225,181,44,179,2,5 (5ct 0st),1.046,2006,2019,BDESH
708,Rashid Latif ,1992-2003,166,164,220,182,38,182,0,5 (5ct 0st),1.341,1992,2003,PAK
709,DPMD Jayawardene ,1998-2015,448,443,218,218,0,0,218,4 (4ct 0st),0.492,1998,2015,SL
710,R Dravid ,1996-2011,344,341,210,196,14,72,124,4 (4ct 0st),0.615,1996,2011,INDIA
711,RS Kaluwitharana ,1990-2004,189,188,207,132,75,131,1,5 (4ct 1st),1.101,1990,2004,SL
712,PJL Dujon ,1981-1991,169,168,204,183,21,183,0,4 (4ct 0st),1.214,1981,1991,WI
713,JC Buttler ,2012-2019,142,138,202,171,31,171,0,6 (6ct 0st),1.463,2012,2019,ENG
714,RD Jacobs ,1996-2004,147,145,189,160,29,160,0,6 (5ct 1st),1.3030000000000002,1996,2004,WI
715,Kamran Akmal ,2002-2017,157,154,188,157,31,156,1,5 (4ct 1st),1.22,2002,2017,PAK
716,D Ramdin ,2005-2016,139,137,188,181,7,181,0,5 (5ct 0st),1.372,2005,2016,WI
717,AB de Villiers ,2005-2018,228,223,181,176,5,93,83,5 (5ct 0st),0.8109999999999999,2005,2018,SA
718,BJ Haddin ,2001-2015,126,124,181,170,11,170,0,5 (5ct 0st),1.459,2001,2015,AUS
719,AJ Stewart ,1989-2003,170,169,174,159,15,148,11,6 (6ct 0st),1.029,1989,2003,ENG
720,A Flower ,1992-2003,213,212,173,141,32,133,8,5 (5ct 0st),0.816,1992,2003,ZIM
721,Q de Kock ,2013-2019,115,111,166,158,8,158,0,6 (5ct 1st),1.495,2013,2019,SA
722,DJ Richardson ,1991-1998,122,121,165,148,17,148,0,5 (5ct 0st),1.3630000000000002,1991,1998,SA
723,RT Ponting ,1995-2012,375,372,160,160,0,0,160,3 (3ct 0st),0.43,1995,2012,AUS
724,M Azharuddin ,1985-2000,334,332,156,156,0,0,156,4 (4ct 0st),0.469,1985,2000,INDIA
725,NR Mongia ,1994-2000,140,139,154,110,44,110,0,5 (4ct 1st),1.107,1994,2000,INDIA
726,BRM Taylor ,2004-2019,193,193,154,125,29,96,29,5 (5ct 0st),0.797,2004,2019,ZIM
727,T Taibu ,2001-2012,150,150,147,114,33,112,2,4 (4ct 0st),0.98,2001,2012,ZIM
728,AC Parore ,1992-2002,179,178,141,116,25,111,5,5 (3ct 2st),0.792,1992,2002,NZ
729,Sarfaraz Ahmed ,2007-2019,116,114,140,116,24,116,0,6 (6ct 0st),1.228,2007,2019,PAK
730,SR Tendulkar ,1989-2012,463,456,140,140,0,0,140,4 (4ct 0st),0.307,1989,2012,INDIA
731,LRPL Taylor ,2006-2019,228,224,137,137,0,0,137,4 (4ct 0st),0.611,2006,2019,NZ
732,Younis Khan ,2000-2015,265,260,135,135,0,5,130,4 (4ct 0st),0.519,2000,2015,PAK
733,SP Fleming ,1994-2007,280,276,133,133,0,0,133,4 (4ct 0st),0.481,1994,2007,NZ
734,JH Kallis ,1996-2014,328,324,131,131,0,0,131,3 (3ct 0st),0.4039999999999999,1996,2014,SA
735,M Muralitharan ,1993-2011,350,347,130,130,0,0,130,3 (3ct 0st),0.374,1993,2011,SL
736,AR Border ,1979-1994,273,270,127,127,0,0,127,3 (3ct 0st),0.47,1979,1994,AUS
737,Shahid Afridi ,1996-2015,398,392,127,127,0,0,127,2 (2ct 0st),0.3229999999999999,1996,2015,PAK
738,Khaled Mashud ,1995-2006,126,126,126,91,35,91,0,5 (3ct 2st),1.0,1995,2006,BDESH
739,TM Dilshan ,1999-2016,330,325,124,123,1,5,118,3 (3ct 0st),0.381,1999,2016,SL
740,CH Gayle ,1999-2019,301,294,124,124,0,0,124,3 (3ct 0st),0.421,1999,2019,WI
741,V Kohli ,2008-2019,242,240,124,124,0,0,124,3 (3ct 0st),0.516,2008,2019,INDIA
742,RW Marsh ,1971-1984,92,92,124,120,4,120,0,5 (5ct 0st),1.347,1971,1984,AUS
743,ST Jayasuriya ,1989-2011,445,441,123,123,0,0,123,3 (3ct 0st),0.278,1989,2011,SL
744,CL Hooper ,1987-2003,227,225,120,120,0,0,120,4 (4ct 0st),0.5329999999999999,1987,2003,WI
745,BC Lara ,1990-2007,299,296,120,120,0,0,120,3 (3ct 0st),0.405,1990,2007,WI
746,L Ronchi ,2008-2017,85,83,117,105,12,105,0,4 (4ct 0st),1.409,2008,2017,AUS
747,MS Wade ,2012-2017,94,94,117,108,9,108,0,5 (5ct 0st),1.244,2012,2017,AUS
748,Inzamam-ul-Haq ,1991-2007,378,373,113,113,0,0,113,3 (3ct 0st),0.302,1991,2007,PAK
749,SR Waugh ,1986-2002,325,324,111,111,0,0,111,3 (3ct 0st),0.342,1986,2002,AUS
750,KC Sangakkara ,2000-2015,404,397,501,402,99,383,19,5 (4ct 1st),1.261,2000,2015,SL
751,AC Gilchrist ,1996-2008,287,286,472,417,55,417,0,6 (6ct 0st),1.65,1996,2008,AUS
752,MS Dhoni ,2004-2019,350,345,444,321,123,321,0,6 (5ct 1st),1.286,2004,2019,INDIA
753,MV Boucher ,1998-2011,295,291,425,403,22,402,1,6 (6ct 0st),1.46,1998,2011,SA
754,Moin Khan ,1990-2004,219,217,287,214,73,214,0,5 (5ct 0st),1.3219999999999998,1990,2004,PAK
755,BB McCullum ,2002-2016,260,257,277,262,15,227,35,5 (5ct 0st),1.077,2002,2016,NZ
756,IA Healy ,1988-1997,168,168,233,194,39,194,0,4 (4ct 0st),1.386,1988,1997,AUS
757,Mushfiqur Rahim ,2006-2019,216,215,225,181,44,179,2,5 (5ct 0st),1.046,2006,2019,BDESH
758,Rashid Latif ,1992-2003,166,164,220,182,38,182,0,5 (5ct 0st),1.341,1992,2003,PAK
759,DPMD Jayawardene ,1998-2015,448,443,218,218,0,0,218,4 (4ct 0st),0.492,1998,2015,SL
760,R Dravid ,1996-2011,344,341,210,196,14,72,124,4 (4ct 0st),0.615,1996,2011,INDIA
761,RS Kaluwitharana ,1990-2004,189,188,207,132,75,131,1,5 (4ct 1st),1.101,1990,2004,SL
762,PJL Dujon ,1981-1991,169,168,204,183,21,183,0,4 (4ct 0st),1.214,1981,1991,WI
763,JC Buttler ,2012-2019,142,138,202,171,31,171,0,6 (6ct 0st),1.463,2012,2019,ENG
764,RD Jacobs ,1996-2004,147,145,189,160,29,160,0,6 (5ct 1st),1.3030000000000002,1996,2004,WI
765,Kamran Akmal ,2002-2017,157,154,188,157,31,156,1,5 (4ct 1st),1.22,2002,2017,PAK
766,D Ramdin ,2005-2016,139,137,188,181,7,181,0,5 (5ct 0st),1.372,2005,2016,WI
767,AB de Villiers ,2005-2018,228,223,181,176,5,93,83,5 (5ct 0st),0.8109999999999999,2005,2018,SA
768,BJ Haddin ,2001-2015,126,124,181,170,11,170,0,5 (5ct 0st),1.459,2001,2015,AUS
769,AJ Stewart ,1989-2003,170,169,174,159,15,148,11,6 (6ct 0st),1.029,1989,2003,ENG
770,A Flower ,1992-2003,213,212,173,141,32,133,8,5 (5ct 0st),0.816,1992,2003,ZIM
771,Q de Kock ,2013-2019,115,111,166,158,8,158,0,6 (5ct 1st),1.495,2013,2019,SA
772,DJ Richardson ,1991-1998,122,121,165,148,17,148,0,5 (5ct 0st),1.3630000000000002,1991,1998,SA
773,RT Ponting ,1995-2012,375,372,160,160,0,0,160,3 (3ct 0st),0.43,1995,2012,AUS
774,M Azharuddin ,1985-2000,334,332,156,156,0,0,156,4 (4ct 0st),0.469,1985,2000,INDIA
775,NR Mongia ,1994-2000,140,139,154,110,44,110,0,5 (4ct 1st),1.107,1994,2000,INDIA
776,BRM Taylor ,2004-2019,193,193,154,125,29,96,29,5 (5ct 0st),0.797,2004,2019,ZIM
777,T Taibu ,2001-2012,150,150,147,114,33,112,2,4 (4ct 0st),0.98,2001,2012,ZIM
778,AC Parore ,1992-2002,179,178,141,116,25,111,5,5 (3ct 2st),0.792,1992,2002,NZ
779,Sarfaraz Ahmed ,2007-2019,116,114,140,116,24,116,0,6 (6ct 0st),1.228,2007,2019,PAK
780,SR Tendulkar ,1989-2012,463,456,140,140,0,0,140,4 (4ct 0st),0.307,1989,2012,INDIA
781,LRPL Taylor ,2006-2019,228,224,137,137,0,0,137,4 (4ct 0st),0.611,2006,2019,NZ
782,Younis Khan ,2000-2015,265,260,135,135,0,5,130,4 (4ct 0st),0.519,2000,2015,PAK
783,SP Fleming ,1994-2007,280,276,133,133,0,0,133,4 (4ct 0st),0.481,1994,2007,NZ
784,JH Kallis ,1996-2014,328,324,131,131,0,0,131,3 (3ct 0st),0.4039999999999999,1996,2014,SA
785,M Muralitharan ,1993-2011,350,347,130,130,0,0,130,3 (3ct 0st),0.374,1993,2011,SL
786,AR Border ,1979-1994,273,270,127,127,0,0,127,3 (3ct 0st),0.47,1979,1994,AUS
787,Shahid Afridi ,1996-2015,398,392,127,127,0,0,127,2 (2ct 0st),0.3229999999999999,1996,2015,PAK
788,Khaled Mashud ,1995-2006,126,126,126,91,35,91,0,5 (3ct 2st),1.0,1995,2006,BDESH
789,TM Dilshan ,1999-2016,330,325,124,123,1,5,118,3 (3ct 0st),0.381,1999,2016,SL
790,CH Gayle ,1999-2019,301,294,124,124,0,0,124,3 (3ct 0st),0.421,1999,2019,WI
791,V Kohli ,2008-2019,242,240,124,124,0,0,124,3 (3ct 0st),0.516,2008,2019,INDIA
792,RW Marsh ,1971-1984,92,92,124,120,4,120,0,5 (5ct 0st),1.347,1971,1984,AUS
793,ST Jayasuriya ,1989-2011,445,441,123,123,0,0,123,3 (3ct 0st),0.278,1989,2011,SL
794,CL Hooper ,1987-2003,227,225,120,120,0,0,120,4 (4ct 0st),0.5329999999999999,1987,2003,WI
795,BC Lara ,1990-2007,299,296,120,120,0,0,120,3 (3ct 0st),0.405,1990,2007,WI
796,L Ronchi ,2008-2017,85,83,117,105,12,105,0,4 (4ct 0st),1.409,2008,2017,AUS
797,MS Wade ,2012-2017,94,94,117,108,9,108,0,5 (5ct 0st),1.244,2012,2017,AUS
798,Inzamam-ul-Haq ,1991-2007,378,373,113,113,0,0,113,3 (3ct 0st),0.302,1991,2007,PAK
799,SR Waugh ,1986-2002,325,324,111,111,0,0,111,3 (3ct 0st),0.342,1986,2002,AUS
800,KC Sangakkara ,2000-2015,404,397,501,402,99,383,19,5 (4ct 1st),1.261,2000,2015,SL
801,AC Gilchrist ,1996-2008,287,286,472,417,55,417,0,6 (6ct 0st),1.65,1996,2008,AUS
802,MS Dhoni ,2004-2019,350,345,444,321,123,321,0,6 (5ct 1st),1.286,2004,2019,INDIA
803,MV Boucher ,1998-2011,295,291,425,403,22,402,1,6 (6ct 0st),1.46,1998,2011,SA
804,Moin Khan ,1990-2004,219,217,287,214,73,214,0,5 (5ct 0st),1.3219999999999998,1990,2004,PAK
805,BB McCullum ,2002-2016,260,257,277,262,15,227,35,5 (5ct 0st),1.077,2002,2016,NZ
806,IA Healy ,1988-1997,168,168,233,194,39,194,0,4 (4ct 0st),1.386,1988,1997,AUS
807,Mushfiqur Rahim ,2006-2019,216,215,225,181,44,179,2,5 (5ct 0st),1.046,2006,2019,BDESH
808,Rashid Latif ,1992-2003,166,164,220,182,38,182,0,5 (5ct 0st),1.341,1992,2003,PAK
809,DPMD Jayawardene ,1998-2015,448,443,218,218,0,0,218,4 (4ct 0st),0.492,1998,2015,SL
810,R Dravid ,1996-2011,344,341,210,196,14,72,124,4 (4ct 0st),0.615,1996,2011,INDIA
811,RS Kaluwitharana ,1990-2004,189,188,207,132,75,131,1,5 (4ct 1st),1.101,1990,2004,SL
812,PJL Dujon ,1981-1991,169,168,204,183,21,183,0,4 (4ct 0st),1.214,1981,1991,WI
813,JC Buttler ,2012-2019,142,138,202,171,31,171,0,6 (6ct 0st),1.463,2012,2019,ENG
814,RD Jacobs ,1996-2004,147,145,189,160,29,160,0,6 (5ct 1st),1.3030000000000002,1996,2004,WI
815,Kamran Akmal ,2002-2017,157,154,188,157,31,156,1,5 (4ct 1st),1.22,2002,2017,PAK
816,D Ramdin ,2005-2016,139,137,188,181,7,181,0,5 (5ct 0st),1.372,2005,2016,WI
817,AB de Villiers ,2005-2018,228,223,181,176,5,93,83,5 (5ct 0st),0.8109999999999999,2005,2018,SA
818,BJ Haddin ,2001-2015,126,124,181,170,11,170,0,5 (5ct 0st),1.459,2001,2015,AUS
819,AJ Stewart ,1989-2003,170,169,174,159,15,148,11,6 (6ct 0st),1.029,1989,2003,ENG
820,A Flower ,1992-2003,213,212,173,141,32,133,8,5 (5ct 0st),0.816,1992,2003,ZIM
821,Q de Kock ,2013-2019,115,111,166,158,8,158,0,6 (5ct 1st),1.495,2013,2019,SA
822,DJ Richardson ,1991-1998,122,121,165,148,17,148,0,5 (5ct 0st),1.3630000000000002,1991,1998,SA
823,RT Ponting ,1995-2012,375,372,160,160,0,0,160,3 (3ct 0st),0.43,1995,2012,AUS
824,M Azharuddin ,1985-2000,334,332,156,156,0,0,156,4 (4ct 0st),0.469,1985,2000,INDIA
825,NR Mongia ,1994-2000,140,139,154,110,44,110,0,5 (4ct 1st),1.107,1994,2000,INDIA
826,BRM Taylor ,2004-2019,193,193,154,125,29,96,29,5 (5ct 0st),0.797,2004,2019,ZIM
827,T Taibu ,2001-2012,150,150,147,114,33,112,2,4 (4ct 0st),0.98,2001,2012,ZIM
828,AC Parore ,1992-2002,179,178,141,116,25,111,5,5 (3ct 2st),0.792,1992,2002,NZ
829,Sarfaraz Ahmed ,2007-2019,116,114,140,116,24,116,0,6 (6ct 0st),1.228,2007,2019,PAK
830,SR Tendulkar ,1989-2012,463,456,140,140,0,0,140,4 (4ct 0st),0.307,1989,2012,INDIA
831,LRPL Taylor ,2006-2019,228,224,137,137,0,0,137,4 (4ct 0st),0.611,2006,2019,NZ
832,Younis Khan ,2000-2015,265,260,135,135,0,5,130,4 (4ct 0st),0.519,2000,2015,PAK
833,SP Fleming ,1994-2007,280,276,133,133,0,0,133,4 (4ct 0st),0.481,1994,2007,NZ
834,JH Kallis ,1996-2014,328,324,131,131,0,0,131,3 (3ct 0st),0.4039999999999999,1996,2014,SA
835,M Muralitharan ,1993-2011,350,347,130,130,0,0,130,3 (3ct 0st),0.374,1993,2011,SL
836,AR Border ,1979-1994,273,270,127,127,0,0,127,3 (3ct 0st),0.47,1979,1994,AUS
837,Shahid Afridi ,1996-2015,398,392,127,127,0,0,127,2 (2ct 0st),0.3229999999999999,1996,2015,PAK
838,Khaled Mashud ,1995-2006,126,126,126,91,35,91,0,5 (3ct 2st),1.0,1995,2006,BDESH
839,TM Dilshan ,1999-2016,330,325,124,123,1,5,118,3 (3ct 0st),0.381,1999,2016,SL
840,CH Gayle ,1999-2019,301,294,124,124,0,0,124,3 (3ct 0st),0.421,1999,2019,WI
841,V Kohli ,2008-2019,242,240,124,124,0,0,124,3 (3ct 0st),0.516,2008,2019,INDIA
842,RW Marsh ,1971-1984,92,92,124,120,4,120,0,5 (5ct 0st),1.347,1971,1984,AUS
843,ST Jayasuriya ,1989-2011,445,441,123,123,0,0,123,3 (3ct 0st),0.278,1989,2011,SL
844,CL Hooper ,1987-2003,227,225,120,120,0,0,120,4 (4ct 0st),0.5329999999999999,1987,2003,WI
845,BC Lara ,1990-2007,299,296,120,120,0,0,120,3 (3ct 0st),0.405,1990,2007,WI
846,L Ronchi ,2008-2017,85,83,117,105,12,105,0,4 (4ct 0st),1.409,2008,2017,AUS
847,MS Wade ,2012-2017,94,94,117,108,9,108,0,5 (5ct 0st),1.244,2012,2017,AUS
848,Inzamam-ul-Haq ,1991-2007,378,373,113,113,0,0,113,3 (3ct 0st),0.302,1991,2007,PAK
849,SR Waugh ,1986-2002,325,324,111,111,0,0,111,3 (3ct 0st),0.342,1986,2002,AUS
850,KC Sangakkara ,2000-2015,404,397,501,402,99,383,19,5 (4ct 1st),1.261,2000,2015,SL
851,AC Gilchrist ,1996-2008,287,286,472,417,55,417,0,6 (6ct 0st),1.65,1996,2008,AUS
852,MS Dhoni ,2004-2019,350,345,444,321,123,321,0,6 (5ct 1st),1.286,2004,2019,INDIA
853,MV Boucher ,1998-2011,295,291,425,403,22,402,1,6 (6ct 0st),1.46,1998,2011,SA
854,Moin Khan ,1990-2004,219,217,287,214,73,214,0,5 (5ct 0st),1.3219999999999998,1990,2004,PAK
855,BB McCullum ,2002-2016,260,257,277,262,15,227,35,5 (5ct 0st),1.077,2002,2016,NZ
856,IA Healy ,1988-1997,168,168,233,194,39,194,0,4 (4ct 0st),1.386,1988,1997,AUS
857,Mushfiqur Rahim ,2006-2019,216,215,225,181,44,179,2,5 (5ct 0st),1.046,2006,2019,BDESH
858,Rashid Latif ,1992-2003,166,164,220,182,38,182,0,5 (5ct 0st),1.341,1992,2003,PAK
859,DPMD Jayawardene ,1998-2015,448,443,218,218,0,0,218,4 (4ct 0st),0.492,1998,2015,SL
860,R Dravid ,1996-2011,344,341,210,196,14,72,124,4 (4ct 0st),0.615,1996,2011,INDIA
861,RS Kaluwitharana ,1990-2004,189,188,207,132,75,131,1,5 (4ct 1st),1.101,1990,2004,SL
862,PJL Dujon ,1981-1991,169,168,204,183,21,183,0,4 (4ct 0st),1.214,1981,1991,WI
863,JC Buttler ,2012-2019,142,138,202,171,31,171,0,6 (6ct 0st),1.463,2012,2019,ENG
864,RD Jacobs ,1996-2004,147,145,189,160,29,160,0,6 (5ct 1st),1.3030000000000002,1996,2004,WI
865,Kamran Akmal ,2002-2017,157,154,188,157,31,156,1,5 (4ct 1st),1.22,2002,2017,PAK
866,D Ramdin ,2005-2016,139,137,188,181,7,181,0,5 (5ct 0st),1.372,2005,2016,WI
867,AB de Villiers ,2005-2018,228,223,181,176,5,93,83,5 (5ct 0st),0.8109999999999999,2005,2018,SA
868,BJ Haddin ,2001-2015,126,124,181,170,11,170,0,5 (5ct 0st),1.459,2001,2015,AUS
869,AJ Stewart ,1989-2003,170,169,174,159,15,148,11,6 (6ct 0st),1.029,1989,2003,ENG
870,A Flower ,1992-2003,213,212,173,141,32,133,8,5 (5ct 0st),0.816,1992,2003,ZIM
871,Q de Kock ,2013-2019,115,111,166,158,8,158,0,6 (5ct 1st),1.495,2013,2019,SA
872,DJ Richardson ,1991-1998,122,121,165,148,17,148,0,5 (5ct 0st),1.3630000000000002,1991,1998,SA
873,RT Ponting ,1995-2012,375,372,160,160,0,0,160,3 (3ct 0st),0.43,1995,2012,AUS
874,M Azharuddin ,1985-2000,334,332,156,156,0,0,156,4 (4ct 0st),0.469,1985,2000,INDIA
875,NR Mongia ,1994-2000,140,139,154,110,44,110,0,5 (4ct 1st),1.107,1994,2000,INDIA
876,BRM Taylor ,2004-2019,193,193,154,125,29,96,29,5 (5ct 0st),0.797,2004,2019,ZIM
877,T Taibu ,2001-2012,150,150,147,114,33,112,2,4 (4ct 0st),0.98,2001,2012,ZIM
878,AC Parore ,1992-2002,179,178,141,116,25,111,5,5 (3ct 2st),0.792,1992,2002,NZ
879,Sarfaraz Ahmed ,2007-2019,116,114,140,116,24,116,0,6 (6ct 0st),1.228,2007,2019,PAK
880,SR Tendulkar ,1989-2012,463,456,140,140,0,0,140,4 (4ct 0st),0.307,1989,2012,INDIA
881,LRPL Taylor ,2006-2019,228,224,137,137,0,0,137,4 (4ct 0st),0.611,2006,2019,NZ
882,Younis Khan ,2000-2015,265,260,135,135,0,5,130,4 (4ct 0st),0.519,2000,2015,PAK
883,SP Fleming ,1994-2007,280,276,133,133,0,0,133,4 (4ct 0st),0.481,1994,2007,NZ
884,JH Kallis ,1996-2014,328,324,131,131,0,0,131,3 (3ct 0st),0.4039999999999999,1996,2014,SA
885,M Muralitharan ,1993-2011,350,347,130,130,0,0,130,3 (3ct 0st),0.374,1993,2011,SL
886,AR Border ,1979-1994,273,270,127,127,0,0,127,3 (3ct 0st),0.47,1979,1994,AUS
887,Shahid Afridi ,1996-2015,398,392,127,127,0,0,127,2 (2ct 0st),0.3229999999999999,1996,2015,PAK
888,Khaled Mashud ,1995-2006,126,126,126,91,35,91,0,5 (3ct 2st),1.0,1995,2006,BDESH
889,TM Dilshan ,1999-2016,330,325,124,123,1,5,118,3 (3ct 0st),0.381,1999,2016,SL
890,CH Gayle ,1999-2019,301,294,124,124,0,0,124,3 (3ct 0st),0.421,1999,2019,WI
891,V Kohli ,2008-2019,242,240,124,124,0,0,124,3 (3ct 0st),0.516,2008,2019,INDIA
892,RW Marsh ,1971-1984,92,92,124,120,4,120,0,5 (5ct 0st),1.347,1971,1984,AUS
893,ST Jayasuriya ,1989-2011,445,441,123,123,0,0,123,3 (3ct 0st),0.278,1989,2011,SL
894,CL Hooper ,1987-2003,227,225,120,120,0,0,120,4 (4ct 0st),0.5329999999999999,1987,2003,WI
895,BC Lara ,1990-2007,299,296,120,120,0,0,120,3 (3ct 0st),0.405,1990,2007,WI
896,L Ronchi ,2008-2017,85,83,117,105,12,105,0,4 (4ct 0st),1.409,2008,2017,AUS
897,MS Wade ,2012-2017,94,94,117,108,9,108,0,5 (5ct 0st),1.244,2012,2017,AUS
898,Inzamam-ul-Haq ,1991-2007,378,373,113,113,0,0,113,3 (3ct 0st),0.302,1991,2007,PAK
899,SR Waugh ,1986-2002,325,324,111,111,0,0,111,3 (3ct 0st),0.342,1986,2002,AUS
900,KC Sangakkara ,2000-2015,404,397,501,402,99,383,19,5 (4ct 1st),1.261,2000,2015,SL
901,AC Gilchrist ,1996-2008,287,286,472,417,55,417,0,6 (6ct 0st),1.65,1996,2008,AUS
902,MS Dhoni ,2004-2019,350,345,444,321,123,321,0,6 (5ct 1st),1.286,2004,2019,INDIA
903,MV Boucher ,1998-2011,295,291,425,403,22,402,1,6 (6ct 0st),1.46,1998,2011,SA
904,Moin Khan ,1990-2004,219,217,287,214,73,214,0,5 (5ct 0st),1.3219999999999998,1990,2004,PAK
905,BB McCullum ,2002-2016,260,257,277,262,15,227,35,5 (5ct 0st),1.077,2002,2016,NZ
906,IA Healy ,1988-1997,168,168,233,194,39,194,0,4 (4ct 0st),1.386,1988,1997,AUS
907,Mushfiqur Rahim ,2006-2019,216,215,225,181,44,179,2,5 (5ct 0st),1.046,2006,2019,BDESH
908,Rashid Latif ,1992-2003,166,164,220,182,38,182,0,5 (5ct 0st),1.341,1992,2003,PAK
909,DPMD Jayawardene ,1998-2015,448,443,218,218,0,0,218,4 (4ct 0st),0.492,1998,2015,SL
910,R Dravid ,1996-2011,344,341,210,196,14,72,124,4 (4ct 0st),0.615,1996,2011,INDIA
911,RS Kaluwitharana ,1990-2004,189,188,207,132,75,131,1,5 (4ct 1st),1.101,1990,2004,SL
912,PJL Dujon ,1981-1991,169,168,204,183,21,183,0,4 (4ct 0st),1.214,1981,1991,WI
913,JC Buttler ,2012-2019,142,138,202,171,31,171,0,6 (6ct 0st),1.463,2012,2019,ENG
914,RD Jacobs ,1996-2004,147,145,189,160,29,160,0,6 (5ct 1st),1.3030000000000002,1996,2004,WI
915,Kamran Akmal ,2002-2017,157,154,188,157,31,156,1,5 (4ct 1st),1.22,2002,2017,PAK
916,D Ramdin ,2005-2016,139,137,188,181,7,181,0,5 (5ct 0st),1.372,2005,2016,WI
917,AB de Villiers ,2005-2018,228,223,181,176,5,93,83,5 (5ct 0st),0.8109999999999999,2005,2018,SA
918,BJ Haddin ,2001-2015,126,124,181,170,11,170,0,5 (5ct 0st),1.459,2001,2015,AUS
919,AJ Stewart ,1989-2003,170,169,174,159,15,148,11,6 (6ct 0st),1.029,1989,2003,ENG
920,A Flower ,1992-2003,213,212,173,141,32,133,8,5 (5ct 0st),0.816,1992,2003,ZIM
921,Q de Kock ,2013-2019,115,111,166,158,8,158,0,6 (5ct 1st),1.495,2013,2019,SA
922,DJ Richardson ,1991-1998,122,121,165,148,17,148,0,5 (5ct 0st),1.3630000000000002,1991,1998,SA
923,RT Ponting ,1995-2012,375,372,160,160,0,0,160,3 (3ct 0st),0.43,1995,2012,AUS
924,M Azharuddin ,1985-2000,334,332,156,156,0,0,156,4 (4ct 0st),0.469,1985,2000,INDIA
925,NR Mongia ,1994-2000,140,139,154,110,44,110,0,5 (4ct 1st),1.107,1994,2000,INDIA
926,BRM Taylor ,2004-2019,193,193,154,125,29,96,29,5 (5ct 0st),0.797,2004,2019,ZIM
927,T Taibu ,2001-2012,150,150,147,114,33,112,2,4 (4ct 0st),0.98,2001,2012,ZIM
928,AC Parore ,1992-2002,179,178,141,116,25,111,5,5 (3ct 2st),0.792,1992,2002,NZ
929,Sarfaraz Ahmed ,2007-2019,116,114,140,116,24,116,0,6 (6ct 0st),1.228,2007,2019,PAK
930,SR Tendulkar ,1989-2012,463,456,140,140,0,0,140,4 (4ct 0st),0.307,1989,2012,INDIA
931,LRPL Taylor ,2006-2019,228,224,137,137,0,0,137,4 (4ct 0st),0.611,2006,2019,NZ
932,Younis Khan ,2000-2015,265,260,135,135,0,5,130,4 (4ct 0st),0.519,2000,2015,PAK
933,SP Fleming ,1994-2007,280,276,133,133,0,0,133,4 (4ct 0st),0.481,1994,2007,NZ
934,JH Kallis ,1996-2014,328,324,131,131,0,0,131,3 (3ct 0st),0.4039999999999999,1996,2014,SA
935,M Muralitharan ,1993-2011,350,347,130,130,0,0,130,3 (3ct 0st),0.374,1993,2011,SL
936,AR Border ,1979-1994,273,270,127,127,0,0,127,3 (3ct 0st),0.47,1979,1994,AUS
937,Shahid Afridi ,1996-2015,398,392,127,127,0,0,127,2 (2ct 0st),0.3229999999999999,1996,2015,PAK
938,Khaled Mashud ,1995-2006,126,126,126,91,35,91,0,5 (3ct 2st),1.0,1995,2006,BDESH
939,TM Dilshan ,1999-2016,330,325,124,123,1,5,118,3 (3ct 0st),0.381,1999,2016,SL
940,CH Gayle ,1999-2019,301,294,124,124,0,0,124,3 (3ct 0st),0.421,1999,2019,WI
941,V Kohli ,2008-2019,242,240,124,124,0,0,124,3 (3ct 0st),0.516,2008,2019,INDIA
942,RW Marsh ,1971-1984,92,92,124,120,4,120,0,5 (5ct 0st),1.347,1971,1984,AUS
943,ST Jayasuriya ,1989-2011,445,441,123,123,0,0,123,3 (3ct 0st),0.278,1989,2011,SL
944,CL Hooper ,1987-2003,227,225,120,120,0,0,120,4 (4ct 0st),0.5329999999999999,1987,2003,WI
945,BC Lara ,1990-2007,299,296,120,120,0,0,120,3 (3ct 0st),0.405,1990,2007,WI
946,L Ronchi ,2008-2017,85,83,117,105,12,105,0,4 (4ct 0st),1.409,2008,2017,AUS
947,MS Wade ,2012-2017,94,94,117,108,9,108,0,5 (5ct 0st),1.244,2012,2017,AUS
948,Inzamam-ul-Haq ,1991-2007,378,373,113,113,0,0,113,3 (3ct 0st),0.302,1991,2007,PAK
949,SR Waugh ,1986-2002,325,324,111,111,0,0,111,3 (3ct 0st),0.342,1986,2002,AUS
950,KC Sangakkara ,2000-2015,404,397,501,402,99,383,19,5 (4ct 1st),1.261,2000,2015,SL
951,AC Gilchrist ,1996-2008,287,286,472,417,55,417,0,6 (6ct 0st),1.65,1996,2008,AUS
952,MS Dhoni ,2004-2019,350,345,444,321,123,321,0,6 (5ct 1st),1.286,2004,2019,INDIA
953,MV Boucher ,1998-2011,295,291,425,403,22,402,1,6 (6ct 0st),1.46,1998,2011,SA
954,Moin Khan ,1990-2004,219,217,287,214,73,214,0,5 (5ct 0st),1.3219999999999998,1990,2004,PAK
955,BB McCullum ,2002-2016,260,257,277,262,15,227,35,5 (5ct 0st),1.077,2002,2016,NZ
956,IA Healy ,1988-1997,168,168,233,194,39,194,0,4 (4ct 0st),1.386,1988,1997,AUS
957,Mushfiqur Rahim ,2006-2019,216,215,225,181,44,179,2,5 (5ct 0st),1.046,2006,2019,BDESH
958,Rashid Latif ,1992-2003,166,164,220,182,38,182,0,5 (5ct 0st),1.341,1992,2003,PAK
959,DPMD Jayawardene ,1998-2015,448,443,218,218,0,0,218,4 (4ct 0st),0.492,1998,2015,SL
960,R Dravid ,1996-2011,344,341,210,196,14,72,124,4 (4ct 0st),0.615,1996,2011,INDIA
961,RS Kaluwitharana ,1990-2004,189,188,207,132,75,131,1,5 (4ct 1st),1.101,1990,2004,SL
962,PJL Dujon ,1981-1991,169,168,204,183,21,183,0,4 (4ct 0st),1.214,1981,1991,WI
963,JC Buttler ,2012-2019,142,138,202,171,31,171,0,6 (6ct 0st),1.463,2012,2019,ENG
964,RD Jacobs ,1996-2004,147,145,189,160,29,160,0,6 (5ct 1st),1.3030000000000002,1996,2004,WI
965,Kamran Akmal ,2002-2017,157,154,188,157,31,156,1,5 (4ct 1st),1.22,2002,2017,PAK
966,D Ramdin ,2005-2016,139,137,188,181,7,181,0,5 (5ct 0st),1.372,2005,2016,WI
967,AB de Villiers ,2005-2018,228,223,181,176,5,93,83,5 (5ct 0st),0.8109999999999999,2005,2018,SA
968,BJ Haddin ,2001-2015,126,124,181,170,11,170,0,5 (5ct 0st),1.459,2001,2015,AUS
969,AJ Stewart ,1989-2003,170,169,174,159,15,148,11,6 (6ct 0st),1.029,1989,2003,ENG
970,A Flower ,1992-2003,213,212,173,141,32,133,8,5 (5ct 0st),0.816,1992,2003,ZIM
971,Q de Kock ,2013-2019,115,111,166,158,8,158,0,6 (5ct 1st),1.495,2013,2019,SA
972,DJ Richardson ,1991-1998,122,121,165,148,17,148,0,5 (5ct 0st),1.3630000000000002,1991,1998,SA
973,RT Ponting ,1995-2012,375,372,160,160,0,0,160,3 (3ct 0st),0.43,1995,2012,AUS
974,M Azharuddin ,1985-2000,334,332,156,156,0,0,156,4 (4ct 0st),0.469,1985,2000,INDIA
975,NR Mongia ,1994-2000,140,139,154,110,44,110,0,5 (4ct 1st),1.107,1994,2000,INDIA
976,BRM Taylor ,2004-2019,193,193,154,125,29,96,29,5 (5ct 0st),0.797,2004,2019,ZIM
977,T Taibu ,2001-2012,150,150,147,114,33,112,2,4 (4ct 0st),0.98,2001,2012,ZIM
978,AC Parore ,1992-2002,179,178,141,116,25,111,5,5 (3ct 2st),0.792,1992,2002,NZ
979,Sarfaraz Ahmed ,2007-2019,116,114,140,116,24,116,0,6 (6ct 0st),1.228,2007,2019,PAK
980,SR Tendulkar ,1989-2012,463,456,140,140,0,0,140,4 (4ct 0st),0.307,1989,2012,INDIA
981,LRPL Taylor ,2006-2019,228,224,137,137,0,0,137,4 (4ct 0st),0.611,2006,2019,NZ
982,Younis Khan ,2000-2015,265,260,135,135,0,5,130,4 (4ct 0st),0.519,2000,2015,PAK
983,SP Fleming ,1994-2007,280,276,133,133,0,0,133,4 (4ct 0st),0.481,1994,2007,NZ
984,JH Kallis ,1996-2014,328,324,131,131,0,0,131,3 (3ct 0st),0.4039999999999999,1996,2014,SA
985,M Muralitharan ,1993-2011,350,347,130,130,0,0,130,3 (3ct 0st),0.374,1993,2011,SL
986,AR Border ,1979-1994,273,270,127,127,0,0,127,3 (3ct 0st),0.47,1979,1994,AUS
987,Shahid Afridi ,1996-2015,398,392,127,127,0,0,127,2 (2ct 0st),0.3229999999999999,1996,2015,PAK
988,Khaled Mashud ,1995-2006,126,126,126,91,35,91,0,5 (3ct 2st),1.0,1995,2006,BDESH
989,TM Dilshan ,1999-2016,330,325,124,123,1,5,118,3 (3ct 0st),0.381,1999,2016,SL
990,CH Gayle ,1999-2019,301,294,124,124,0,0,124,3 (3ct 0st),0.421,1999,2019,WI
991,V Kohli ,2008-2019,242,240,124,124,0,0,124,3 (3ct 0st),0.516,2008,2019,INDIA
992,RW Marsh ,1971-1984,92,92,124,120,4,120,0,5 (5ct 0st),1.347,1971,1984,AUS
993,ST Jayasuriya ,1989-2011,445,441,123,123,0,0,123,3 (3ct 0st),0.278,1989,2011,SL
994,CL Hooper ,1987-2003,227,225,120,120,0,0,120,4 (4ct 0st),0.5329999999999999,1987,2003,WI
995,BC Lara ,1990-2007,299,296,120,120,0,0,120,3 (3ct 0st),0.405,1990,2007,WI
996,L Ronchi ,2008-2017,85,83,117,105,12,105,0,4 (4ct 0st),1.409,2008,2017,AUS
997,MS Wade ,2012-2017,94,94,117,108,9,108,0,5 (5ct 0st),1.244,2012,2017,AUS
998,Inzamam-ul-Haq ,1991-2007,378,373,113,113,0,0,113,3 (3ct 0st),0.302,1991,2007,PAK
999,SR Waugh ,1986-2002,325,324,111,111,0,0,111,3 (3ct 0st),0.342,1986,2002,AUS
1000,KC Sangakkara ,2000-2015,404,397,501,402,99,383,19,5 (4ct 1st),1.261,2000,2015,SL
1001,AC Gilchrist ,1996-2008,287,286,472,417,55,417,0,6 (6ct 0st),1.65,1996,2008,AUS
1002,MS Dhoni ,2004-2019,350,345,444,321,123,321,0,6 (5ct 1st),1.286,2004,2019,INDIA
1003,MV Boucher ,1998-2011,295,291,425,403,22,402,1,6 (6ct 0st),1.46,1998,2011,SA
1004,Moin Khan ,1990-2004,219,217,287,214,73,214,0,5 (5ct 0st),1.3219999999999998,1990,2004,PAK
1005,BB McCullum ,2002-2016,260,257,277,262,15,227,35,5 (5ct 0st),1.077,2002,2016,NZ
1006,IA Healy ,1988-1997,168,168,233,194,39,194,0,4 (4ct 0st),1.386,1988,1997,AUS
1007,Mushfiqur Rahim ,2006-2019,216,215,225,181,44,179,2,5 (5ct 0st),1.046,2006,2019,BDESH
1008,Rashid Latif ,1992-2003,166,164,220,182,38,182,0,5 (5ct 0st),1.341,1992,2003,PAK
1009,DPMD Jayawardene ,1998-2015,448,443,218,218,0,0,218,4 (4ct 0st),0.492,1998,2015,SL
1010,R Dravid ,1996-2011,344,341,210,196,14,72,124,4 (4ct 0st),0.615,1996,2011,INDIA
1011,RS Kaluwitharana ,1990-2004,189,188,207,132,75,131,1,5 (4ct 1st),1.101,1990,2004,SL
1012,PJL Dujon ,1981-1991,169,168,204,183,21,183,0,4 (4ct 0st),1.214,1981,1991,WI
1013,JC Buttler ,2012-2019,142,138,202,171,31,171,0,6 (6ct 0st),1.463,2012,2019,ENG
1014,RD Jacobs ,1996-2004,147,145,189,160,29,160,0,6 (5ct 1st),1.3030000000000002,1996,2004,WI
1015,Kamran Akmal ,2002-2017,157,154,188,157,31,156,1,5 (4ct 1st),1.22,2002,2017,PAK
1016,D Ramdin ,2005-2016,139,137,188,181,7,181,0,5 (5ct 0st),1.372,2005,2016,WI
1017,AB de Villiers ,2005-2018,228,223,181,176,5,93,83,5 (5ct 0st),0.8109999999999999,2005,2018,SA
1018,BJ Haddin ,2001-2015,126,124,181,170,11,170,0,5 (5ct 0st),1.459,2001,2015,AUS
1019,AJ Stewart ,1989-2003,170,169,174,159,15,148,11,6 (6ct 0st),1.029,1989,2003,ENG
1020,A Flower ,1992-2003,213,212,173,141,32,133,8,5 (5ct 0st),0.816,1992,2003,ZIM
1021,Q de Kock ,2013-2019,115,111,166,158,8,158,0,6 (5ct 1st),1.495,2013,2019,SA
1022,DJ Richardson ,1991-1998,122,121,165,148,17,148,0,5 (5ct 0st),1.3630000000000002,1991,1998,SA
1023,RT Ponting ,1995-2012,375,372,160,160,0,0,160,3 (3ct 0st),0.43,1995,2012,AUS
1024,M Azharuddin ,1985-2000,334,332,156,156,0,0,156,4 (4ct 0st),0.469,1985,2000,INDIA
1025,NR Mongia ,1994-2000,140,139,154,110,44,110,0,5 (4ct 1st),1.107,1994,2000,INDIA
1026,BRM Taylor ,2004-2019,193,193,154,125,29,96,29,5 (5ct 0st),0.797,2004,2019,ZIM
1027,T Taibu ,2001-2012,150,150,147,114,33,112,2,4 (4ct 0st),0.98,2001,2012,ZIM
1028,AC Parore ,1992-2002,179,178,141,116,25,111,5,5 (3ct 2st),0.792,1992,2002,NZ
1029,Sarfaraz Ahmed ,2007-2019,116,114,140,116,24,116,0,6 (6ct 0st),1.228,2007,2019,PAK
1030,SR Tendulkar ,1989-2012,463,456,140,140,0,0,140,4 (4ct 0st),0.307,1989,2012,INDIA
1031,LRPL Taylor ,2006-2019,228,224,137,137,0,0,137,4 (4ct 0st),0.611,2006,2019,NZ
1032,Younis Khan ,2000-2015,265,260,135,135,0,5,130,4 (4ct 0st),0.519,2000,2015,PAK
1033,SP Fleming ,1994-2007,280,276,133,133,0,0,133,4 (4ct 0st),0.481,1994,2007,NZ
1034,JH Kallis ,1996-2014,328,324,131,131,0,0,131,3 (3ct 0st),0.4039999999999999,1996,2014,SA
1035,M Muralitharan ,1993-2011,350,347,130,130,0,0,130,3 (3ct 0st),0.374,1993,2011,SL
1036,AR Border ,1979-1994,273,270,127,127,0,0,127,3 (3ct 0st),0.47,1979,1994,AUS
1037,Shahid Afridi ,1996-2015,398,392,127,127,0,0,127,2 (2ct 0st),0.3229999999999999,1996,2015,PAK
1038,Khaled Mashud ,1995-2006,126,126,126,91,35,91,0,5 (3ct 2st),1.0,1995,2006,BDESH
1039,TM Dilshan ,1999-2016,330,325,124,123,1,5,118,3 (3ct 0st),0.381,1999,2016,SL
1040,CH Gayle ,1999-2019,301,294,124,124,0,0,124,3 (3ct 0st),0.421,1999,2019,WI
1041,V Kohli ,2008-2019,242,240,124,124,0,0,124,3 (3ct 0st),0.516,2008,2019,INDIA
1042,RW Marsh ,1971-1984,92,92,124,120,4,120,0,5 (5ct 0st),1.347,1971,1984,AUS
1043,ST Jayasuriya ,1989-2011,445,441,123,123,0,0,123,3 (3ct 0st),0.278,1989,2011,SL
1044,CL Hooper ,1987-2003,227,225,120,120,0,0,120,4 (4ct 0st),0.5329999999999999,1987,2003,WI
1045,BC Lara ,1990-2007,299,296,120,120,0,0,120,3 (3ct 0st),0.405,1990,2007,WI
1046,L Ronchi ,2008-2017,85,83,117,105,12,105,0,4 (4ct 0st),1.409,2008,2017,AUS
1047,MS Wade ,2012-2017,94,94,117,108,9,108,0,5 (5ct 0st),1.244,2012,2017,AUS
1048,Inzamam-ul-Haq ,1991-2007,378,373,113,113,0,0,113,3 (3ct 0st),0.302,1991,2007,PAK
1049,SR Waugh ,1986-2002,325,324,111,111,0,0,111,3 (3ct 0st),0.342,1986,2002,AUS
1050,KC Sangakkara ,2000-2015,404,397,501,402,99,383,19,5 (4ct 1st),1.261,2000,2015,SL
1051,AC Gilchrist ,1996-2008,287,286,472,417,55,417,0,6 (6ct 0st),1.65,1996,2008,AUS
1052,MS Dhoni ,2004-2019,350,345,444,321,123,321,0,6 (5ct 1st),1.286,2004,2019,INDIA
1053,MV Boucher ,1998-2011,295,291,425,403,22,402,1,6 (6ct 0st),1.46,1998,2011,SA
1054,Moin Khan ,1990-2004,219,217,287,214,73,214,0,5 (5ct 0st),1.3219999999999998,1990,2004,PAK
1055,BB McCullum ,2002-2016,260,257,277,262,15,227,35,5 (5ct 0st),1.077,2002,2016,NZ
1056,IA Healy ,1988-1997,168,168,233,194,39,194,0,4 (4ct 0st),1.386,1988,1997,AUS
1057,Mushfiqur Rahim ,2006-2019,216,215,225,181,44,179,2,5 (5ct 0st),1.046,2006,2019,BDESH
1058,Rashid Latif ,1992-2003,166,164,220,182,38,182,0,5 (5ct 0st),1.341,1992,2003,PAK
1059,DPMD Jayawardene ,1998-2015,448,443,218,218,0,0,218,4 (4ct 0st),0.492,1998,2015,SL
1060,R Dravid ,1996-2011,344,341,210,196,14,72,124,4 (4ct 0st),0.615,1996,2011,INDIA
1061,RS Kaluwitharana ,1990-2004,189,188,207,132,75,131,1,5 (4ct 1st),1.101,1990,2004,SL
1062,PJL Dujon ,1981-1991,169,168,204,183,21,183,0,4 (4ct 0st),1.214,1981,1991,WI
1063,JC Buttler ,2012-2019,142,138,202,171,31,171,0,6 (6ct 0st),1.463,2012,2019,ENG
1064,RD Jacobs ,1996-2004,147,145,189,160,29,160,0,6 (5ct 1st),1.3030000000000002,1996,2004,WI
1065,Kamran Akmal ,2002-2017,157,154,188,157,31,156,1,5 (4ct 1st),1.22,2002,2017,PAK
1066,D Ramdin ,2005-2016,139,137,188,181,7,181,0,5 (5ct 0st),1.372,2005,2016,WI
1067,AB de Villiers ,2005-2018,228,223,181,176,5,93,83,5 (5ct 0st),0.8109999999999999,2005,2018,SA
1068,BJ Haddin ,2001-2015,126,124,181,170,11,170,0,5 (5ct 0st),1.459,2001,2015,AUS
1069,AJ Stewart ,1989-2003,170,169,174,159,15,148,11,6 (6ct 0st),1.029,1989,2003,ENG
1070,A Flower ,1992-2003,213,212,173,141,32,133,8,5 (5ct 0st),0.816,1992,2003,ZIM
1071,Q de Kock ,2013-2019,115,111,166,158,8,158,0,6 (5ct 1st),1.495,2013,2019,SA
1072,DJ Richardson ,1991-1998,122,121,165,148,17,148,0,5 (5ct 0st),1.3630000000000002,1991,1998,SA
1073,RT Ponting ,1995-2012,375,372,160,160,0,0,160,3 (3ct 0st),0.43,1995,2012,AUS
1074,M Azharuddin ,1985-2000,334,332,156,156,0,0,156,4 (4ct 0st),0.469,1985,2000,INDIA
1075,NR Mongia ,1994-2000,140,139,154,110,44,110,0,5 (4ct 1st),1.107,1994,2000,INDIA
1076,BRM Taylor ,2004-2019,193,193,154,125,29,96,29,5 (5ct 0st),0.797,2004,2019,ZIM
1077,T Taibu ,2001-2012,150,150,147,114,33,112,2,4 (4ct 0st),0.98,2001,2012,ZIM
1078,AC Parore ,1992-2002,179,178,141,116,25,111,5,5 (3ct 2st),0.792,1992,2002,NZ
1079,Sarfaraz Ahmed ,2007-2019,116,114,140,116,24,116,0,6 (6ct 0st),1.228,2007,2019,PAK
1080,SR Tendulkar ,1989-2012,463,456,140,140,0,0,140,4 (4ct 0st),0.307,1989,2012,INDIA
1081,LRPL Taylor ,2006-2019,228,224,137,137,0,0,137,4 (4ct 0st),0.611,2006,2019,NZ
1082,Younis Khan ,2000-2015,265,260,135,135,0,5,130,4 (4ct 0st),0.519,2000,2015,PAK
1083,SP Fleming ,1994-2007,280,276,133,133,0,0,133,4 (4ct 0st),0.481,1994,2007,NZ
1084,JH Kallis ,1996-2014,328,324,131,131,0,0,131,3 (3ct 0st),0.4039999999999999,1996,2014,SA
1085,M Muralitharan ,1993-2011,350,347,130,130,0,0,130,3 (3ct 0st),0.374,1993,2011,SL
1086,AR Border ,1979-1994,273,270,127,127,0,0,127,3 (3ct 0st),0.47,1979,1994,AUS
1087,Shahid Afridi ,1996-2015,398,392,127,127,0,0,127,2 (2ct 0st),0.3229999999999999,1996,2015,PAK
1088,Khaled Mashud ,1995-2006,126,126,126,91,35,91,0,5 (3ct 2st),1.0,1995,2006,BDESH
1089,TM Dilshan ,1999-2016,330,325,124,123,1,5,118,3 (3ct 0st),0.381,1999,2016,SL
1090,CH Gayle ,1999-2019,301,294,124,124,0,0,124,3 (3ct 0st),0.421,1999,2019,WI
1091,V Kohli ,2008-2019,242,240,124,124,0,0,124,3 (3ct 0st),0.516,2008,2019,INDIA
1092,RW Marsh ,1971-1984,92,92,124,120,4,120,0,5 (5ct 0st),1.347,1971,1984,AUS
1093,ST Jayasuriya ,1989-2011,445,441,123,123,0,0,123,3 (3ct 0st),0.278,1989,2011,SL
1094,CL Hooper ,1987-2003,227,225,120,120,0,0,120,4 (4ct 0st),0.5329999999999999,1987,2003,WI
1095,BC Lara ,1990-2007,299,296,120,120,0,0,120,3 (3ct 0st),0.405,1990,2007,WI
1096,L Ronchi ,2008-2017,85,83,117,105,12,105,0,4 (4ct 0st),1.409,2008,2017,AUS
1097,MS Wade ,2012-2017,94,94,117,108,9,108,0,5 (5ct 0st),1.244,2012,2017,AUS
1098,Inzamam-ul-Haq ,1991-2007,378,373,113,113,0,0,113,3 (3ct 0st),0.302,1991,2007,PAK
1099,SR Waugh ,1986-2002,325,324,111,111,0,0,111,3 (3ct 0st),0.342,1986,2002,AUS
1100,KC Sangakkara ,2000-2015,404,397,501,402,99,383,19,5 (4ct 1st),1.261,2000,2015,SL
1101,AC Gilchrist ,1996-2008,287,286,472,417,55,417,0,6 (6ct 0st),1.65,1996,2008,AUS
1102,MS Dhoni ,2004-2019,350,345,444,321,123,321,0,6 (5ct 1st),1.286,2004,2019,INDIA
1103,MV Boucher ,1998-2011,295,291,425,403,22,402,1,6 (6ct 0st),1.46,1998,2011,SA
1104,Moin Khan ,1990-2004,219,217,287,214,73,214,0,5 (5ct 0st),1.3219999999999998,1990,2004,PAK
1105,BB McCullum ,2002-2016,260,257,277,262,15,227,35,5 (5ct 0st),1.077,2002,2016,NZ
1106,IA Healy ,1988-1997,168,168,233,194,39,194,0,4 (4ct 0st),1.386,1988,1997,AUS
1107,Mushfiqur Rahim ,2006-2019,216,215,225,181,44,179,2,5 (5ct 0st),1.046,2006,2019,BDESH
1108,Rashid Latif ,1992-2003,166,164,220,182,38,182,0,5 (5ct 0st),1.341,1992,2003,PAK
1109,DPMD Jayawardene ,1998-2015,448,443,218,218,0,0,218,4 (4ct 0st),0.492,1998,2015,SL
1110,R Dravid ,1996-2011,344,341,210,196,14,72,124,4 (4ct 0st),0.615,1996,2011,INDIA
1111,RS Kaluwitharana ,1990-2004,189,188,207,132,75,131,1,5 (4ct 1st),1.101,1990,2004,SL
1112,PJL Dujon ,1981-1991,169,168,204,183,21,183,0,4 (4ct 0st),1.214,1981,1991,WI
1113,JC Buttler ,2012-2019,142,138,202,171,31,171,0,6 (6ct 0st),1.463,2012,2019,ENG
1114,RD Jacobs ,1996-2004,147,145,189,160,29,160,0,6 (5ct 1st),1.3030000000000002,1996,2004,WI
1115,Kamran Akmal ,2002-2017,157,154,188,157,31,156,1,5 (4ct 1st),1.22,2002,2017,PAK
1116,D Ramdin ,2005-2016,139,137,188,181,7,181,0,5 (5ct 0st),1.372,2005,2016,WI
1117,AB de Villiers ,2005-2018,228,223,181,176,5,93,83,5 (5ct 0st),0.8109999999999999,2005,2018,SA
1118,BJ Haddin ,2001-2015,126,124,181,170,11,170,0,5 (5ct 0st),1.459,2001,2015,AUS
1119,AJ Stewart ,1989-2003,170,169,174,159,15,148,11,6 (6ct 0st),1.029,1989,2003,ENG
1120,A Flower ,1992-2003,213,212,173,141,32,133,8,5 (5ct 0st),0.816,1992,2003,ZIM
1121,Q de Kock ,2013-2019,115,111,166,158,8,158,0,6 (5ct 1st),1.495,2013,2019,SA
1122,DJ Richardson ,1991-1998,122,121,165,148,17,148,0,5 (5ct 0st),1.3630000000000002,1991,1998,SA
1123,RT Ponting ,1995-2012,375,372,160,160,0,0,160,3 (3ct 0st),0.43,1995,2012,AUS
1124,M Azharuddin ,1985-2000,334,332,156,156,0,0,156,4 (4ct 0st),0.469,1985,2000,INDIA
1125,NR Mongia ,1994-2000,140,139,154,110,44,110,0,5 (4ct 1st),1.107,1994,2000,INDIA
1126,BRM Taylor ,2004-2019,193,193,154,125,29,96,29,5 (5ct 0st),0.797,2004,2019,ZIM
1127,T Taibu ,2001-2012,150,150,147,114,33,112,2,4 (4ct 0st),0.98,2001,2012,ZIM
1128,AC Parore ,1992-2002,179,178,141,116,25,111,5,5 (3ct 2st),0.792,1992,2002,NZ
1129,Sarfaraz Ahmed ,2007-2019,116,114,140,116,24,116,0,6 (6ct 0st),1.228,2007,2019,PAK
1130,SR Tendulkar ,1989-2012,463,456,140,140,0,0,140,4 (4ct 0st),0.307,1989,2012,INDIA
1131,LRPL Taylor ,2006-2019,228,224,137,137,0,0,137,4 (4ct 0st),0.611,2006,2019,NZ
1132,Younis Khan ,2000-2015,265,260,135,135,0,5,130,4 (4ct 0st),0.519,2000,2015,PAK
1133,SP Fleming ,1994-2007,280,276,133,133,0,0,133,4 (4ct 0st),0.481,1994,2007,NZ
1134,JH Kallis ,1996-2014,328,324,131,131,0,0,131,3 (3ct 0st),0.4039999999999999,1996,2014,SA
1135,M Muralitharan ,1993-2011,350,347,130,130,0,0,130,3 (3ct 0st),0.374,1993,2011,SL
1136,AR Border ,1979-1994,273,270,127,127,0,0,127,3 (3ct 0st),0.47,1979,1994,AUS
1137,Shahid Afridi ,1996-2015,398,392,127,127,0,0,127,2 (2ct 0st),0.3229999999999999,1996,2015,PAK
1138,Khaled Mashud ,1995-2006,126,126,126,91,35,91,0,5 (3ct 2st),1.0,1995,2006,BDESH
1139,TM Dilshan ,1999-2016,330,325,124,123,1,5,118,3 (3ct 0st),0.381,1999,2016,SL
1140,CH Gayle ,1999-2019,301,294,124,124,0,0,124,3 (3ct 0st),0.421,1999,2019,WI
1141,V Kohli ,2008-2019,242,240,124,124,0,0,124,3 (3ct 0st),0.516,2008,2019,INDIA
1142,RW Marsh ,1971-1984,92,92,124,120,4,120,0,5 (5ct 0st),1.347,1971,1984,AUS
1143,ST Jayasuriya ,1989-2011,445,441,123,123,0,0,123,3 (3ct 0st),0.278,1989,2011,SL
1144,CL Hooper ,1987-2003,227,225,120,120,0,0,120,4 (4ct 0st),0.5329999999999999,1987,2003,WI
1145,BC Lara ,1990-2007,299,296,120,120,0,0,120,3 (3ct 0st),0.405,1990,2007,WI
1146,L Ronchi ,2008-2017,85,83,117,105,12,105,0,4 (4ct 0st),1.409,2008,2017,AUS
1147,MS Wade ,2012-2017,94,94,117,108,9,108,0,5 (5ct 0st),1.244,2012,2017,AUS
1148,Inzamam-ul-Haq ,1991-2007,378,373,113,113,0,0,113,3 (3ct 0st),0.302,1991,2007,PAK
1149,SR Waugh ,1986-2002,325,324,111,111,0,0,111,3 (3ct 0st),0.342,1986,2002,AUS
1150,KC Sangakkara ,2000-2015,404,397,501,402,99,383,19,5 (4ct 1st),1.261,2000,2015,SL
1151,AC Gilchrist ,1996-2008,287,286,472,417,55,417,0,6 (6ct 0st),1.65,1996,2008,AUS
1152,MS Dhoni ,2004-2019,350,345,444,321,123,321,0,6 (5ct 1st),1.286,2004,2019,INDIA
1153,MV Boucher ,1998-2011,295,291,425,403,22,402,1,6 (6ct 0st),1.46,1998,2011,SA
1154,Moin Khan ,1990-2004,219,217,287,214,73,214,0,5 (5ct 0st),1.3219999999999998,1990,2004,PAK
1155,BB McCullum ,2002-2016,260,257,277,262,15,227,35,5 (5ct 0st),1.077,2002,2016,NZ
1156,IA Healy ,1988-1997,168,168,233,194,39,194,0,4 (4ct 0st),1.386,1988,1997,AUS
1157,Mushfiqur Rahim ,2006-2019,216,215,225,181,44,179,2,5 (5ct 0st),1.046,2006,2019,BDESH
1158,Rashid Latif ,1992-2003,166,164,220,182,38,182,0,5 (5ct 0st),1.341,1992,2003,PAK
1159,DPMD Jayawardene ,1998-2015,448,443,218,218,0,0,218,4 (4ct 0st),0.492,1998,2015,SL
1160,R Dravid ,1996-2011,344,341,210,196,14,72,124,4 (4ct 0st),0.615,1996,2011,INDIA
1161,RS Kaluwitharana ,1990-2004,189,188,207,132,75,131,1,5 (4ct 1st),1.101,1990,2004,SL
1162,PJL Dujon ,1981-1991,169,168,204,183,21,183,0,4 (4ct 0st),1.214,1981,1991,WI
1163,JC Buttler ,2012-2019,142,138,202,171,31,171,0,6 (6ct 0st),1.463,2012,2019,ENG
1164,RD Jacobs ,1996-2004,147,145,189,160,29,160,0,6 (5ct 1st),1.3030000000000002,1996,2004,WI
1165,Kamran Akmal ,2002-2017,157,154,188,157,31,156,1,5 (4ct 1st),1.22,2002,2017,PAK
1166,D Ramdin ,2005-2016,139,137,188,181,7,181,0,5 (5ct 0st),1.372,2005,2016,WI
1167,AB de Villiers ,2005-2018,228,223,181,176,5,93,83,5 (5ct 0st),0.8109999999999999,2005,2018,SA
1168,BJ Haddin ,2001-2015,126,124,181,170,11,170,0,5 (5ct 0st),1.459,2001,2015,AUS
1169,AJ Stewart ,1989-2003,170,169,174,159,15,148,11,6 (6ct 0st),1.029,1989,2003,ENG
1170,A Flower ,1992-2003,213,212,173,141,32,133,8,5 (5ct 0st),0.816,1992,2003,ZIM
1171,Q de Kock ,2013-2019,115,111,166,158,8,158,0,6 (5ct 1st),1.495,2013,2019,SA
1172,DJ Richardson ,1991-1998,122,121,165,148,17,148,0,5 (5ct 0st),1.3630000000000002,1991,1998,SA
1173,RT Ponting ,1995-2012,375,372,160,160,0,0,160,3 (3ct 0st),0.43,1995,2012,AUS
1174,M Azharuddin ,1985-2000,334,332,156,156,0,0,156,4 (4ct 0st),0.469,1985,2000,INDIA
1175,NR Mongia ,1994-2000,140,139,154,110,44,110,0,5 (4ct 1st),1.107,1994,2000,INDIA
1176,BRM Taylor ,2004-2019,193,193,154,125,29,96,29,5 (5ct 0st),0.797,2004,2019,ZIM
1177,T Taibu ,2001-2012,150,150,147,114,33,112,2,4 (4ct 0st),0.98,2001,2012,ZIM
1178,AC Parore ,1992-2002,179,178,141,116,25,111,5,5 (3ct 2st),0.792,1992,2002,NZ
1179,Sarfaraz Ahmed ,2007-2019,116,114,140,116,24,116,0,6 (6ct 0st),1.228,2007,2019,PAK
1180,SR Tendulkar ,1989-2012,463,456,140,140,0,0,140,4 (4ct 0st),0.307,1989,2012,INDIA
1181,LRPL Taylor ,2006-2019,228,224,137,137,0,0,137,4 (4ct 0st),0.611,2006,2019,NZ
1182,Younis Khan ,2000-2015,265,260,135,135,0,5,130,4 (4ct 0st),0.519,2000,2015,PAK
1183,SP Fleming ,1994-2007,280,276,133,133,0,0,133,4 (4ct 0st),0.481,1994,2007,NZ
1184,JH Kallis ,1996-2014,328,324,131,131,0,0,131,3 (3ct 0st),0.4039999999999999,1996,2014,SA
1185,M Muralitharan ,1993-2011,350,347,130,130,0,0,130,3 (3ct 0st),0.374,1993,2011,SL
1186,AR Border ,1979-1994,273,270,127,127,0,0,127,3 (3ct 0st),0.47,1979,1994,AUS
1187,Shahid Afridi ,1996-2015,398,392,127,127,0,0,127,2 (2ct 0st),0.3229999999999999,1996,2015,PAK
1188,Khaled Mashud ,1995-2006,126,126,126,91,35,91,0,5 (3ct 2st),1.0,1995,2006,BDESH
1189,TM Dilshan ,1999-2016,330,325,124,123,1,5,118,3 (3ct 0st),0.381,1999,2016,SL
1190,CH Gayle ,1999-2019,301,294,124,124,0,0,124,3 (3ct 0st),0.421,1999,2019,WI
1191,V Kohli ,2008-2019,242,240,124,124,0,0,124,3 (3ct 0st),0.516,2008,2019,INDIA
1192,RW Marsh ,1971-1984,92,92,124,120,4,120,0,5 (5ct 0st),1.347,1971,1984,AUS
1193,ST Jayasuriya ,1989-2011,445,441,123,123,0,0,123,3 (3ct 0st),0.278,1989,2011,SL
1194,CL Hooper ,1987-2003,227,225,120,120,0,0,120,4 (4ct 0st),0.5329999999999999,1987,2003,WI
1195,BC Lara ,1990-2007,299,296,120,120,0,0,120,3 (3ct 0st),0.405,1990,2007,WI
1196,L Ronchi ,2008-2017,85,83,117,105,12,105,0,4 (4ct 0st),1.409,2008,2017,AUS
1197,MS Wade ,2012-2017,94,94,117,108,9,108,0,5 (5ct 0st),1.244,2012,2017,AUS
1198,Inzamam-ul-Haq ,1991-2007,378,373,113,113,0,0,113,3 (3ct 0st),0.302,1991,2007,PAK
1199,SR Waugh ,1986-2002,325,324,111,111,0,0,111,3 (3ct 0st),0.342,1986,2002,AUS
1200,KC Sangakkara ,2000-2015,404,397,501,402,99,383,19,5 (4ct 1st),1.261,2000,2015,SL
1201,AC Gilchrist ,1996-2008,287,286,472,417,55,417,0,6 (6ct 0st),1.65,1996,2008,AUS
1202,MS Dhoni ,2004-2019,350,345,444,321,123,321,0,6 (5ct 1st),1.286,2004,2019,INDIA
1203,MV Boucher ,1998-2011,295,291,425,403,22,402,1,6 (6ct 0st),1.46,1998,2011,SA
1204,Moin Khan ,1990-2004,219,217,287,214,73,214,0,5 (5ct 0st),1.3219999999999998,1990,2004,PAK
1205,BB McCullum ,2002-2016,260,257,277,262,15,227,35,5 (5ct 0st),1.077,2002,2016,NZ
1206,IA Healy ,1988-1997,168,168,233,194,39,194,0,4 (4ct 0st),1.386,1988,1997,AUS
1207,Mushfiqur Rahim ,2006-2019,216,215,225,181,44,179,2,5 (5ct 0st),1.046,2006,2019,BDESH
1208,Rashid Latif ,1992-2003,166,164,220,182,38,182,0,5 (5ct 0st),1.341,1992,2003,PAK
1209,DPMD Jayawardene ,1998-2015,448,443,218,218,0,0,218,4 (4ct 0st),0.492,1998,2015,SL
1210,R Dravid ,1996-2011,344,341,210,196,14,72,124,4 (4ct 0st),0.615,1996,2011,INDIA
1211,RS Kaluwitharana ,1990-2004,189,188,207,132,75,131,1,5 (4ct 1st),1.101,1990,2004,SL
1212,PJL Dujon ,1981-1991,169,168,204,183,21,183,0,4 (4ct 0st),1.214,1981,1991,WI
1213,JC Buttler ,2012-2019,142,138,202,171,31,171,0,6 (6ct 0st),1.463,2012,2019,ENG
1214,RD Jacobs ,1996-2004,147,145,189,160,29,160,0,6 (5ct 1st),1.3030000000000002,1996,2004,WI
1215,Kamran Akmal ,2002-2017,157,154,188,157,31,156,1,5 (4ct 1st),1.22,2002,2017,PAK
1216,D Ramdin ,2005-2016,139,137,188,181,7,181,0,5 (5ct 0st),1.372,2005,2016,WI
1217,AB de Villiers ,2005-2018,228,223,181,176,5,93,83,5 (5ct 0st),0.8109999999999999,2005,2018,SA
1218,BJ Haddin ,2001-2015,126,124,181,170,11,170,0,5 (5ct 0st),1.459,2001,2015,AUS
1219,AJ Stewart ,1989-2003,170,169,174,159,15,148,11,6 (6ct 0st),1.029,1989,2003,ENG
1220,A Flower ,1992-2003,213,212,173,141,32,133,8,5 (5ct 0st),0.816,1992,2003,ZIM
1221,Q de Kock ,2013-2019,115,111,166,158,8,158,0,6 (5ct 1st),1.495,2013,2019,SA
1222,DJ Richardson ,1991-1998,122,121,165,148,17,148,0,5 (5ct 0st),1.3630000000000002,1991,1998,SA
1223,RT Ponting ,1995-2012,375,372,160,160,0,0,160,3 (3ct 0st),0.43,1995,2012,AUS
1224,M Azharuddin ,1985-2000,334,332,156,156,0,0,156,4 (4ct 0st),0.469,1985,2000,INDIA
1225,NR Mongia ,1994-2000,140,139,154,110,44,110,0,5 (4ct 1st),1.107,1994,2000,INDIA
1226,BRM Taylor ,2004-2019,193,193,154,125,29,96,29,5 (5ct 0st),0.797,2004,2019,ZIM
1227,T Taibu ,2001-2012,150,150,147,114,33,112,2,4 (4ct 0st),0.98,2001,2012,ZIM
1228,AC Parore ,1992-2002,179,178,141,116,25,111,5,5 (3ct 2st),0.792,1992,2002,NZ
1229,Sarfaraz Ahmed ,2007-2019,116,114,140,116,24,116,0,6 (6ct 0st),1.228,2007,2019,PAK
1230,SR Tendulkar ,1989-2012,463,456,140,140,0,0,140,4 (4ct 0st),0.307,1989,2012,INDIA
1231,LRPL Taylor ,2006-2019,228,224,137,137,0,0,137,4 (4ct 0st),0.611,2006,2019,NZ
1232,Younis Khan ,2000-2015,265,260,135,135,0,5,130,4 (4ct 0st),0.519,2000,2015,PAK
1233,SP Fleming ,1994-2007,280,276,133,133,0,0,133,4 (4ct 0st),0.481,1994,2007,NZ
1234,JH Kallis ,1996-2014,328,324,131,131,0,0,131,3 (3ct 0st),0.4039999999999999,1996,2014,SA
1235,M Muralitharan ,1993-2011,350,347,130,130,0,0,130,3 (3ct 0st),0.374,1993,2011,SL
1236,AR Border ,1979-1994,273,270,127,127,0,0,127,3 (3ct 0st),0.47,1979,1994,AUS
1237,Shahid Afridi ,1996-2015,398,392,127,127,0,0,127,2 (2ct 0st),0.3229999999999999,1996,2015,PAK
1238,Khaled Mashud ,1995-2006,126,126,126,91,35,91,0,5 (3ct 2st),1.0,1995,2006,BDESH
1239,TM Dilshan ,1999-2016,330,325,124,123,1,5,118,3 (3ct 0st),0.381,1999,2016,SL
1240,CH Gayle ,1999-2019,301,294,124,124,0,0,124,3 (3ct 0st),0.421,1999,2019,WI
1241,V Kohli ,2008-2019,242,240,124,124,0,0,124,3 (3ct 0st),0.516,2008,2019,INDIA
1242,RW Marsh ,1971-1984,92,92,124,120,4,120,0,5 (5ct 0st),1.347,1971,1984,AUS
1243,ST Jayasuriya ,1989-2011,445,441,123,123,0,0,123,3 (3ct 0st),0.278,1989,2011,SL
1244,CL Hooper ,1987-2003,227,225,120,120,0,0,120,4 (4ct 0st),0.5329999999999999,1987,2003,WI
1245,BC Lara ,1990-2007,299,296,120,120,0,0,120,3 (3ct 0st),0.405,1990,2007,WI
1246,L Ronchi ,2008-2017,85,83,117,105,12,105,0,4 (4ct 0st),1.409,2008,2017,AUS
1247,MS Wade ,2012-2017,94,94,117,108,9,108,0,5 (5ct 0st),1.244,2012,2017,AUS
1248,Inzamam-ul-Haq ,1991-2007,378,373,113,113,0,0,113,3 (3ct 0st),0.302,1991,2007,PAK
1249,SR Waugh ,1986-2002,325,324,111,111,0,0,111,3 (3ct 0st),0.342,1986,2002,AUS
1250,KC Sangakkara ,2000-2015,404,397,501,402,99,383,19,5 (4ct 1st),1.261,2000,2015,SL
1251,AC Gilchrist ,1996-2008,287,286,472,417,55,417,0,6 (6ct 0st),1.65,1996,2008,AUS
1252,MS Dhoni ,2004-2019,350,345,444,321,123,321,0,6 (5ct 1st),1.286,2004,2019,INDIA
1253,MV Boucher ,1998-2011,295,291,425,403,22,402,1,6 (6ct 0st),1.46,1998,2011,SA
1254,Moin Khan ,1990-2004,219,217,287,214,73,214,0,5 (5ct 0st),1.3219999999999998,1990,2004,PAK
1255,BB McCullum ,2002-2016,260,257,277,262,15,227,35,5 (5ct 0st),1.077,2002,2016,NZ
1256,IA Healy ,1988-1997,168,168,233,194,39,194,0,4 (4ct 0st),1.386,1988,1997,AUS
1257,Mushfiqur Rahim ,2006-2019,216,215,225,181,44,179,2,5 (5ct 0st),1.046,2006,2019,BDESH
1258,Rashid Latif ,1992-2003,166,164,220,182,38,182,0,5 (5ct 0st),1.341,1992,2003,PAK
1259,DPMD Jayawardene ,1998-2015,448,443,218,218,0,0,218,4 (4ct 0st),0.492,1998,2015,SL
1260,R Dravid ,1996-2011,344,341,210,196,14,72,124,4 (4ct 0st),0.615,1996,2011,INDIA
1261,RS Kaluwitharana ,1990-2004,189,188,207,132,75,131,1,5 (4ct 1st),1.101,1990,2004,SL
1262,PJL Dujon ,1981-1991,169,168,204,183,21,183,0,4 (4ct 0st),1.214,1981,1991,WI
1263,JC Buttler ,2012-2019,142,138,202,171,31,171,0,6 (6ct 0st),1.463,2012,2019,ENG
1264,RD Jacobs ,1996-2004,147,145,189,160,29,160,0,6 (5ct 1st),1.3030000000000002,1996,2004,WI
1265,Kamran Akmal ,2002-2017,157,154,188,157,31,156,1,5 (4ct 1st),1.22,2002,2017,PAK
1266,D Ramdin ,2005-2016,139,137,188,181,7,181,0,5 (5ct 0st),1.372,2005,2016,WI
1267,AB de Villiers ,2005-2018,228,223,181,176,5,93,83,5 (5ct 0st),0.8109999999999999,2005,2018,SA
1268,BJ Haddin ,2001-2015,126,124,181,170,11,170,0,5 (5ct 0st),1.459,2001,2015,AUS
1269,AJ Stewart ,1989-2003,170,169,174,159,15,148,11,6 (6ct 0st),1.029,1989,2003,ENG
1270,A Flower ,1992-2003,213,212,173,141,32,133,8,5 (5ct 0st),0.816,1992,2003,ZIM
1271,Q de Kock ,2013-2019,115,111,166,158,8,158,0,6 (5ct 1st),1.495,2013,2019,SA
1272,DJ Richardson ,1991-1998,122,121,165,148,17,148,0,5 (5ct 0st),1.3630000000000002,1991,1998,SA
1273,RT Ponting ,1995-2012,375,372,160,160,0,0,160,3 (3ct 0st),0.43,1995,2012,AUS
1274,M Azharuddin ,1985-2000,334,332,156,156,0,0,156,4 (4ct 0st),0.469,1985,2000,INDIA
1275,NR Mongia ,1994-2000,140,139,154,110,44,110,0,5 (4ct 1st),1.107,1994,2000,INDIA
1276,BRM Taylor ,2004-2019,193,193,154,125,29,96,29,5 (5ct 0st),0.797,2004,2019,ZIM
1277,T Taibu ,2001-2012,150,150,147,114,33,112,2,4 (4ct 0st),0.98,2001,2012,ZIM
1278,AC Parore ,1992-2002,179,178,141,116,25,111,5,5 (3ct 2st),0.792,1992,2002,NZ
1279,Sarfaraz Ahmed ,2007-2019,116,114,140,116,24,116,0,6 (6ct 0st),1.228,2007,2019,PAK
1280,SR Tendulkar ,1989-2012,463,456,140,140,0,0,140,4 (4ct 0st),0.307,1989,2012,INDIA
1281,LRPL Taylor ,2006-2019,228,224,137,137,0,0,137,4 (4ct 0st),0.611,2006,2019,NZ
1282,Younis Khan ,2000-2015,265,260,135,135,0,5,130,4 (4ct 0st),0.519,2000,2015,PAK
1283,SP Fleming ,1994-2007,280,276,133,133,0,0,133,4 (4ct 0st),0.481,1994,2007,NZ
1284,JH Kallis ,1996-2014,328,324,131,131,0,0,131,3 (3ct 0st),0.4039999999999999,1996,2014,SA
1285,M Muralitharan ,1993-2011,350,347,130,130,0,0,130,3 (3ct 0st),0.374,1993,2011,SL
1286,AR Border ,1979-1994,273,270,127,127,0,0,127,3 (3ct 0st),0.47,1979,1994,AUS
1287,Shahid Afridi ,1996-2015,398,392,127,127,0,0,127,2 (2ct 0st),0.3229999999999999,1996,2015,PAK
1288,Khaled Mashud ,1995-2006,126,126,126,91,35,91,0,5 (3ct 2st),1.0,1995,2006,BDESH
1289,TM Dilshan ,1999-2016,330,325,124,123,1,5,118,3 (3ct 0st),0.381,1999,2016,SL
1290,CH Gayle ,1999-2019,301,294,124,124,0,0,124,3 (3ct 0st),0.421,1999,2019,WI
1291,V Kohli ,2008-2019,242,240,124,124,0,0,124,3 (3ct 0st),0.516,2008,2019,INDIA
1292,RW Marsh ,1971-1984,92,92,124,120,4,120,0,5 (5ct 0st),1.347,1971,1984,AUS
1293,ST Jayasuriya ,1989-2011,445,441,123,123,0,0,123,3 (3ct 0st),0.278,1989,2011,SL
1294,CL Hooper ,1987-2003,227,225,120,120,0,0,120,4 (4ct 0st),0.5329999999999999,1987,2003,WI
1295,BC Lara ,1990-2007,299,296,120,120,0,0,120,3 (3ct 0st),0.405,1990,2007,WI
1296,L Ronchi ,2008-2017,85,83,117,105,12,105,0,4 (4ct 0st),1.409,2008,2017,AUS
1297,MS Wade ,2012-2017,94,94,117,108,9,108,0,5 (5ct 0st),1.244,2012,2017,AUS
1298,Inzamam-ul-Haq ,1991-2007,378,373,113,113,0,0,113,3 (3ct 0st),0.302,1991,2007,PAK
1299,SR Waugh ,1986-2002,325,324,111,111,0,0,111,3 (3ct 0st),0.342,1986,2002,AUS
1300,KC Sangakkara ,2000-2015,404,397,501,402,99,383,19,5 (4ct 1st),1.261,2000,2015,SL
1301,AC Gilchrist ,1996-2008,287,286,472,417,55,417,0,6 (6ct 0st),1.65,1996,2008,AUS
1302,MS Dhoni ,2004-2019,350,345,444,321,123,321,0,6 (5ct 1st),1.286,2004,2019,INDIA
1303,MV Boucher ,1998-2011,295,291,425,403,22,402,1,6 (6ct 0st),1.46,1998,2011,SA
1304,Moin Khan ,1990-2004,219,217,287,214,73,214,0,5 (5ct 0st),1.3219999999999998,1990,2004,PAK
1305,BB McCullum ,2002-2016,260,257,277,262,15,227,35,5 (5ct 0st),1.077,2002,2016,NZ
1306,IA Healy ,1988-1997,168,168,233,194,39,194,0,4 (4ct 0st),1.386,1988,1997,AUS
1307,Mushfiqur Rahim ,2006-2019,216,215,225,181,44,179,2,5 (5ct 0st),1.046,2006,2019,BDESH
1308,Rashid Latif ,1992-2003,166,164,220,182,38,182,0,5 (5ct 0st),1.341,1992,2003,PAK
1309,DPMD Jayawardene ,1998-2015,448,443,218,218,0,0,218,4 (4ct 0st),0.492,1998,2015,SL
1310,R Dravid ,1996-2011,344,341,210,196,14,72,124,4 (4ct 0st),0.615,1996,2011,INDIA
1311,RS Kaluwitharana ,1990-2004,189,188,207,132,75,131,1,5 (4ct 1st),1.101,1990,2004,SL
1312,PJL Dujon ,1981-1991,169,168,204,183,21,183,0,4 (4ct 0st),1.214,1981,1991,WI
1313,JC Buttler ,2012-2019,142,138,202,171,31,171,0,6 (6ct 0st),1.463,2012,2019,ENG
1314,RD Jacobs ,1996-2004,147,145,189,160,29,160,0,6 (5ct 1st),1.3030000000000002,1996,2004,WI
1315,Kamran Akmal ,2002-2017,157,154,188,157,31,156,1,5 (4ct 1st),1.22,2002,2017,PAK
1316,D Ramdin ,2005-2016,139,137,188,181,7,181,0,5 (5ct 0st),1.372,2005,2016,WI
1317,AB de Villiers ,2005-2018,228,223,181,176,5,93,83,5 (5ct 0st),0.8109999999999999,2005,2018,SA
1318,BJ Haddin ,2001-2015,126,124,181,170,11,170,0,5 (5ct 0st),1.459,2001,2015,AUS
1319,AJ Stewart ,1989-2003,170,169,174,159,15,148,11,6 (6ct 0st),1.029,1989,2003,ENG
1320,A Flower ,1992-2003,213,212,173,141,32,133,8,5 (5ct 0st),0.816,1992,2003,ZIM
1321,Q de Kock ,2013-2019,115,111,166,158,8,158,0,6 (5ct 1st),1.495,2013,2019,SA
1322,DJ Richardson ,1991-1998,122,121,165,148,17,148,0,5 (5ct 0st),1.3630000000000002,1991,1998,SA
1323,RT Ponting ,1995-2012,375,372,160,160,0,0,160,3 (3ct 0st),0.43,1995,2012,AUS
1324,M Azharuddin ,1985-2000,334,332,156,156,0,0,156,4 (4ct 0st),0.469,1985,2000,INDIA
1325,NR Mongia ,1994-2000,140,139,154,110,44,110,0,5 (4ct 1st),1.107,1994,2000,INDIA
1326,BRM Taylor ,2004-2019,193,193,154,125,29,96,29,5 (5ct 0st),0.797,2004,2019,ZIM
1327,T Taibu ,2001-2012,150,150,147,114,33,112,2,4 (4ct 0st),0.98,2001,2012,ZIM
1328,AC Parore ,1992-2002,179,178,141,116,25,111,5,5 (3ct 2st),0.792,1992,2002,NZ
1329,Sarfaraz Ahmed ,2007-2019,116,114,140,116,24,116,0,6 (6ct 0st),1.228,2007,2019,PAK
1330,SR Tendulkar ,1989-2012,463,456,140,140,0,0,140,4 (4ct 0st),0.307,1989,2012,INDIA
1331,LRPL Taylor ,2006-2019,228,224,137,137,0,0,137,4 (4ct 0st),0.611,2006,2019,NZ
1332,Younis Khan ,2000-2015,265,260,135,135,0,5,130,4 (4ct 0st),0.519,2000,2015,PAK
1333,SP Fleming ,1994-2007,280,276,133,133,0,0,133,4 (4ct 0st),0.481,1994,2007,NZ
1334,JH Kallis ,1996-2014,328,324,131,131,0,0,131,3 (3ct 0st),0.4039999999999999,1996,2014,SA
1335,M Muralitharan ,1993-2011,350,347,130,130,0,0,130,3 (3ct 0st),0.374,1993,2011,SL
1336,AR Border ,1979-1994,273,270,127,127,0,0,127,3 (3ct 0st),0.47,1979,1994,AUS
1337,Shahid Afridi ,1996-2015,398,392,127,127,0,0,127,2 (2ct 0st),0.3229999999999999,1996,2015,PAK
1338,Khaled Mashud ,1995-2006,126,126,126,91,35,91,0,5 (3ct 2st),1.0,1995,2006,BDESH
1339,TM Dilshan ,1999-2016,330,325,124,123,1,5,118,3 (3ct 0st),0.381,1999,2016,SL
1340,CH Gayle ,1999-2019,301,294,124,124,0,0,124,3 (3ct 0st),0.421,1999,2019,WI
1341,V Kohli ,2008-2019,242,240,124,124,0,0,124,3 (3ct 0st),0.516,2008,2019,INDIA
1342,RW Marsh ,1971-1984,92,92,124,120,4,120,0,5 (5ct 0st),1.347,1971,1984,AUS
1343,ST Jayasuriya ,1989-2011,445,441,123,123,0,0,123,3 (3ct 0st),0.278,1989,2011,SL
1344,CL Hooper ,1987-2003,227,225,120,120,0,0,120,4 (4ct 0st),0.5329999999999999,1987,2003,WI
1345,BC Lara ,1990-2007,299,296,120,120,0,0,120,3 (3ct 0st),0.405,1990,2007,WI
1346,L Ronchi ,2008-2017,85,83,117,105,12,105,0,4 (4ct 0st),1.409,2008,2017,AUS
1347,MS Wade ,2012-2017,94,94,117,108,9,108,0,5 (5ct 0st),1.244,2012,2017,AUS
1348,Inzamam-ul-Haq ,1991-2007,378,373,113,113,0,0,113,3 (3ct 0st),0.302,1991,2007,PAK
1349,SR Waugh ,1986-2002,325,324,111,111,0,0,111,3 (3ct 0st),0.342,1986,2002,AUS
1350,KC Sangakkara ,2000-2015,404,397,501,402,99,383,19,5 (4ct 1st),1.261,2000,2015,SL
1351,AC Gilchrist ,1996-2008,287,286,472,417,55,417,0,6 (6ct 0st),1.65,1996,2008,AUS
1352,MS Dhoni ,2004-2019,350,345,444,321,123,321,0,6 (5ct 1st),1.286,2004,2019,INDIA
1353,MV Boucher ,1998-2011,295,291,425,403,22,402,1,6 (6ct 0st),1.46,1998,2011,SA
1354,Moin Khan ,1990-2004,219,217,287,214,73,214,0,5 (5ct 0st),1.3219999999999998,1990,2004,PAK
1355,BB McCullum ,2002-2016,260,257,277,262,15,227,35,5 (5ct 0st),1.077,2002,2016,NZ
1356,IA Healy ,1988-1997,168,168,233,194,39,194,0,4 (4ct 0st),1.386,1988,1997,AUS
1357,Mushfiqur Rahim ,2006-2019,216,215,225,181,44,179,2,5 (5ct 0st),1.046,2006,2019,BDESH
1358,Rashid Latif ,1992-2003,166,164,220,182,38,182,0,5 (5ct 0st),1.341,1992,2003,PAK
1359,DPMD Jayawardene ,1998-2015,448,443,218,218,0,0,218,4 (4ct 0st),0.492,1998,2015,SL
1360,R Dravid ,1996-2011,344,341,210,196,14,72,124,4 (4ct 0st),0.615,1996,2011,INDIA
1361,RS Kaluwitharana ,1990-2004,189,188,207,132,75,131,1,5 (4ct 1st),1.101,1990,2004,SL
1362,PJL Dujon ,1981-1991,169,168,204,183,21,183,0,4 (4ct 0st),1.214,1981,1991,WI
1363,JC Buttler ,2012-2019,142,138,202,171,31,171,0,6 (6ct 0st),1.463,2012,2019,ENG
1364,RD Jacobs ,1996-2004,147,145,189,160,29,160,0,6 (5ct 1st),1.3030000000000002,1996,2004,WI
1365,Kamran Akmal ,2002-2017,157,154,188,157,31,156,1,5 (4ct 1st),1.22,2002,2017,PAK
1366,D Ramdin ,2005-2016,139,137,188,181,7,181,0,5 (5ct 0st),1.372,2005,2016,WI
1367,AB de Villiers ,2005-2018,228,223,181,176,5,93,83,5 (5ct 0st),0.8109999999999999,2005,2018,SA
1368,BJ Haddin ,2001-2015,126,124,181,170,11,170,0,5 (5ct 0st),1.459,2001,2015,AUS
1369,AJ Stewart ,1989-2003,170,169,174,159,15,148,11,6 (6ct 0st),1.029,1989,2003,ENG
1370,A Flower ,1992-2003,213,212,173,141,32,133,8,5 (5ct 0st),0.816,1992,2003,ZIM
1371,Q de Kock ,2013-2019,115,111,166,158,8,158,0,6 (5ct 1st),1.495,2013,2019,SA
1372,DJ Richardson ,1991-1998,122,121,165,148,17,148,0,5 (5ct 0st),1.3630000000000002,1991,1998,SA
1373,RT Ponting ,1995-2012,375,372,160,160,0,0,160,3 (3ct 0st),0.43,1995,2012,AUS
1374,M Azharuddin ,1985-2000,334,332,156,156,0,0,156,4 (4ct 0st),0.469,1985,2000,INDIA
1375,NR Mongia ,1994-2000,140,139,154,110,44,110,0,5 (4ct 1st),1.107,1994,2000,INDIA
1376,BRM Taylor ,2004-2019,193,193,154,125,29,96,29,5 (5ct 0st),0.797,2004,2019,ZIM
1377,T Taibu ,2001-2012,150,150,147,114,33,112,2,4 (4ct 0st),0.98,2001,2012,ZIM
1378,AC Parore ,1992-2002,179,178,141,116,25,111,5,5 (3ct 2st),0.792,1992,2002,NZ
1379,Sarfaraz Ahmed ,2007-2019,116,114,140,116,24,116,0,6 (6ct 0st),1.228,2007,2019,PAK
1380,SR Tendulkar ,1989-2012,463,456,140,140,0,0,140,4 (4ct 0st),0.307,1989,2012,INDIA
1381,LRPL Taylor ,2006-2019,228,224,137,137,0,0,137,4 (4ct 0st),0.611,2006,2019,NZ
1382,Younis Khan ,2000-2015,265,260,135,135,0,5,130,4 (4ct 0st),0.519,2000,2015,PAK
1383,SP Fleming ,1994-2007,280,276,133,133,0,0,133,4 (4ct 0st),0.481,1994,2007,NZ
1384,JH Kallis ,1996-2014,328,324,131,131,0,0,131,3 (3ct 0st),0.4039999999999999,1996,2014,SA
1385,M Muralitharan ,1993-2011,350,347,130,130,0,0,130,3 (3ct 0st),0.374,1993,2011,SL
1386,AR Border ,1979-1994,273,270,127,127,0,0,127,3 (3ct 0st),0.47,1979,1994,AUS
1387,Shahid Afridi ,1996-2015,398,392,127,127,0,0,127,2 (2ct 0st),0.3229999999999999,1996,2015,PAK
1388,Khaled Mashud ,1995-2006,126,126,126,91,35,91,0,5 (3ct 2st),1.0,1995,2006,BDESH
1389,TM Dilshan ,1999-2016,330,325,124,123,1,5,118,3 (3ct 0st),0.381,1999,2016,SL
1390,CH Gayle ,1999-2019,301,294,124,124,0,0,124,3 (3ct 0st),0.421,1999,2019,WI
1391,V Kohli ,2008-2019,242,240,124,124,0,0,124,3 (3ct 0st),0.516,2008,2019,INDIA
1392,RW Marsh ,1971-1984,92,92,124,120,4,120,0,5 (5ct 0st),1.347,1971,1984,AUS
1393,ST Jayasuriya ,1989-2011,445,441,123,123,0,0,123,3 (3ct 0st),0.278,1989,2011,SL
1394,CL Hooper ,1987-2003,227,225,120,120,0,0,120,4 (4ct 0st),0.5329999999999999,1987,2003,WI
1395,BC Lara ,1990-2007,299,296,120,120,0,0,120,3 (3ct 0st),0.405,1990,2007,WI
1396,L Ronchi ,2008-2017,85,83,117,105,12,105,0,4 (4ct 0st),1.409,2008,2017,AUS
1397,MS Wade ,2012-2017,94,94,117,108,9,108,0,5 (5ct 0st),1.244,2012,2017,AUS
1398,Inzamam-ul-Haq ,1991-2007,378,373,113,113,0,0,113,3 (3ct 0st),0.302,1991,2007,PAK
1399,SR Waugh ,1986-2002,325,324,111,111,0,0,111,3 (3ct 0st),0.342,1986,2002,AUS
1400,KC Sangakkara ,2000-2015,404,397,501,402,99,383,19,5 (4ct 1st),1.261,2000,2015,SL
1401,AC Gilchrist ,1996-2008,287,286,472,417,55,417,0,6 (6ct 0st),1.65,1996,2008,AUS
1402,MS Dhoni ,2004-2019,350,345,444,321,123,321,0,6 (5ct 1st),1.286,2004,2019,INDIA
1403,MV Boucher ,1998-2011,295,291,425,403,22,402,1,6 (6ct 0st),1.46,1998,2011,SA
1404,Moin Khan ,1990-2004,219,217,287,214,73,214,0,5 (5ct 0st),1.3219999999999998,1990,2004,PAK
1405,BB McCullum ,2002-2016,260,257,277,262,15,227,35,5 (5ct 0st),1.077,2002,2016,NZ
1406,IA Healy ,1988-1997,168,168,233,194,39,194,0,4 (4ct 0st),1.386,1988,1997,AUS
1407,Mushfiqur Rahim ,2006-2019,216,215,225,181,44,179,2,5 (5ct 0st),1.046,2006,2019,BDESH
1408,Rashid Latif ,1992-2003,166,164,220,182,38,182,0,5 (5ct 0st),1.341,1992,2003,PAK
1409,DPMD Jayawardene ,1998-2015,448,443,218,218,0,0,218,4 (4ct 0st),0.492,1998,2015,SL
1410,R Dravid ,1996-2011,344,341,210,196,14,72,124,4 (4ct 0st),0.615,1996,2011,INDIA
1411,RS Kaluwitharana ,1990-2004,189,188,207,132,75,131,1,5 (4ct 1st),1.101,1990,2004,SL
1412,PJL Dujon ,1981-1991,169,168,204,183,21,183,0,4 (4ct 0st),1.214,1981,1991,WI
1413,JC Buttler ,2012-2019,142,138,202,171,31,171,0,6 (6ct 0st),1.463,2012,2019,ENG
1414,RD Jacobs ,1996-2004,147,145,189,160,29,160,0,6 (5ct 1st),1.3030000000000002,1996,2004,WI
1415,Kamran Akmal ,2002-2017,157,154,188,157,31,156,1,5 (4ct 1st),1.22,2002,2017,PAK
1416,D Ramdin ,2005-2016,139,137,188,181,7,181,0,5 (5ct 0st),1.372,2005,2016,WI
1417,AB de Villiers ,2005-2018,228,223,181,176,5,93,83,5 (5ct 0st),0.8109999999999999,2005,2018,SA
1418,BJ Haddin ,2001-2015,126,124,181,170,11,170,0,5 (5ct 0st),1.459,2001,2015,AUS
1419,AJ Stewart ,1989-2003,170,169,174,159,15,148,11,6 (6ct 0st),1.029,1989,2003,ENG
1420,A Flower ,1992-2003,213,212,173,141,32,133,8,5 (5ct 0st),0.816,1992,2003,ZIM
1421,Q de Kock ,2013-2019,115,111,166,158,8,158,0,6 (5ct 1st),1.495,2013,2019,SA
1422,DJ Richardson ,1991-1998,122,121,165,148,17,148,0,5 (5ct 0st),1.3630000000000002,1991,1998,SA
1423,RT Ponting ,1995-2012,375,372,160,160,0,0,160,3 (3ct 0st),0.43,1995,2012,AUS
1424,M Azharuddin ,1985-2000,334,332,156,156,0,0,156,4 (4ct 0st),0.469,1985,2000,INDIA
1425,NR Mongia ,1994-2000,140,139,154,110,44,110,0,5 (4ct 1st),1.107,1994,2000,INDIA
1426,BRM Taylor ,2004-2019,193,193,154,125,29,96,29,5 (5ct 0st),0.797,2004,2019,ZIM
1427,T Taibu ,2001-2012,150,150,147,114,33,112,2,4 (4ct 0st),0.98,2001,2012,ZIM
1428,AC Parore ,1992-2002,179,178,141,116,25,111,5,5 (3ct 2st),0.792,1992,2002,NZ
1429,Sarfaraz Ahmed ,2007-2019,116,114,140,116,24,116,0,6 (6ct 0st),1.228,2007,2019,PAK
1430,SR Tendulkar ,1989-2012,463,456,140,140,0,0,140,4 (4ct 0st),0.307,1989,2012,INDIA
1431,LRPL Taylor ,2006-2019,228,224,137,137,0,0,137,4 (4ct 0st),0.611,2006,2019,NZ
1432,Younis Khan ,2000-2015,265,260,135,135,0,5,130,4 (4ct 0st),0.519,2000,2015,PAK
1433,SP Fleming ,1994-2007,280,276,133,133,0,0,133,4 (4ct 0st),0.481,1994,2007,NZ
1434,JH Kallis ,1996-2014,328,324,131,131,0,0,131,3 (3ct 0st),0.4039999999999999,1996,2014,SA
1435,M Muralitharan ,1993-2011,350,347,130,130,0,0,130,3 (3ct 0st),0.374,1993,2011,SL
1436,AR Border ,1979-1994,273,270,127,127,0,0,127,3 (3ct 0st),0.47,1979,1994,AUS
1437,Shahid Afridi ,1996-2015,398,392,127,127,0,0,127,2 (2ct 0st),0.3229999999999999,1996,2015,PAK
1438,Khaled Mashud ,1995-2006,126,126,126,91,35,91,0,5 (3ct 2st),1.0,1995,2006,BDESH
1439,TM Dilshan ,1999-2016,330,325,124,123,1,5,118,3 (3ct 0st),0.381,1999,2016,SL
1440,CH Gayle ,1999-2019,301,294,124,124,0,0,124,3 (3ct 0st),0.421,1999,2019,WI
1441,V Kohli ,2008-2019,242,240,124,124,0,0,124,3 (3ct 0st),0.516,2008,2019,INDIA
1442,RW Marsh ,1971-1984,92,92,124,120,4,120,0,5 (5ct 0st),1.347,1971,1984,AUS
1443,ST Jayasuriya ,1989-2011,445,441,123,123,0,0,123,3 (3ct 0st),0.278,1989,2011,SL
1444,CL Hooper ,1987-2003,227,225,120,120,0,0,120,4 (4ct 0st),0.5329999999999999,1987,2003,WI
1445,BC Lara ,1990-2007,299,296,120,120,0,0,120,3 (3ct 0st),0.405,1990,2007,WI
1446,L Ronchi ,2008-2017,85,83,117,105,12,105,0,4 (4ct 0st),1.409,2008,2017,AUS
1447,MS Wade ,2012-2017,94,94,117,108,9,108,0,5 (5ct 0st),1.244,2012,2017,AUS
1448,Inzamam-ul-Haq ,1991-2007,378,373,113,113,0,0,113,3 (3ct 0st),0.302,1991,2007,PAK
1449,SR Waugh ,1986-2002,325,324,111,111,0,0,111,3 (3ct 0st),0.342,1986,2002,AUS
1450,KC Sangakkara ,2000-2015,404,397,501,402,99,383,19,5 (4ct 1st),1.261,2000,2015,SL
1451,AC Gilchrist ,1996-2008,287,286,472,417,55,417,0,6 (6ct 0st),1.65,1996,2008,AUS
1452,MS Dhoni ,2004-2019,350,345,444,321,123,321,0,6 (5ct 1st),1.286,2004,2019,INDIA
1453,MV Boucher ,1998-2011,295,291,425,403,22,402,1,6 (6ct 0st),1.46,1998,2011,SA
1454,Moin Khan ,1990-2004,219,217,287,214,73,214,0,5 (5ct 0st),1.3219999999999998,1990,2004,PAK
1455,BB McCullum ,2002-2016,260,257,277,262,15,227,35,5 (5ct 0st),1.077,2002,2016,NZ
1456,IA Healy ,1988-1997,168,168,233,194,39,194,0,4 (4ct 0st),1.386,1988,1997,AUS
1457,Mushfiqur Rahim ,2006-2019,216,215,225,181,44,179,2,5 (5ct 0st),1.046,2006,2019,BDESH
1458,Rashid Latif ,1992-2003,166,164,220,182,38,182,0,5 (5ct 0st),1.341,1992,2003,PAK
1459,DPMD Jayawardene ,1998-2015,448,443,218,218,0,0,218,4 (4ct 0st),0.492,1998,2015,SL
1460,R Dravid ,1996-2011,344,341,210,196,14,72,124,4 (4ct 0st),0.615,1996,2011,INDIA
1461,RS Kaluwitharana ,1990-2004,189,188,207,132,75,131,1,5 (4ct 1st),1.101,1990,2004,SL
1462,PJL Dujon ,1981-1991,169,168,204,183,21,183,0,4 (4ct 0st),1.214,1981,1991,WI
1463,JC Buttler ,2012-2019,142,138,202,171,31,171,0,6 (6ct 0st),1.463,2012,2019,ENG
1464,RD Jacobs ,1996-2004,147,145,189,160,29,160,0,6 (5ct 1st),1.3030000000000002,1996,2004,WI
1465,Kamran Akmal ,2002-2017,157,154,188,157,31,156,1,5 (4ct 1st),1.22,2002,2017,PAK
1466,D Ramdin ,2005-2016,139,137,188,181,7,181,0,5 (5ct 0st),1.372,2005,2016,WI
1467,AB de Villiers ,2005-2018,228,223,181,176,5,93,83,5 (5ct 0st),0.8109999999999999,2005,2018,SA
1468,BJ Haddin ,2001-2015,126,124,181,170,11,170,0,5 (5ct 0st),1.459,2001,2015,AUS
1469,AJ Stewart ,1989-2003,170,169,174,159,15,148,11,6 (6ct 0st),1.029,1989,2003,ENG
1470,A Flower ,1992-2003,213,212,173,141,32,133,8,5 (5ct 0st),0.816,1992,2003,ZIM
1471,Q de Kock ,2013-2019,115,111,166,158,8,158,0,6 (5ct 1st),1.495,2013,2019,SA
1472,DJ Richardson ,1991-1998,122,121,165,148,17,148,0,5 (5ct 0st),1.3630000000000002,1991,1998,SA
1473,RT Ponting ,1995-2012,375,372,160,160,0,0,160,3 (3ct 0st),0.43,1995,2012,AUS
1474,M Azharuddin ,1985-2000,334,332,156,156,0,0,156,4 (4ct 0st),0.469,1985,2000,INDIA
1475,NR Mongia ,1994-2000,140,139,154,110,44,110,0,5 (4ct 1st),1.107,1994,2000,INDIA
1476,BRM Taylor ,2004-2019,193,193,154,125,29,96,29,5 (5ct 0st),0.797,2004,2019,ZIM
1477,T Taibu ,2001-2012,150,150,147,114,33,112,2,4 (4ct 0st),0.98,2001,2012,ZIM
1478,AC Parore ,1992-2002,179,178,141,116,25,111,5,5 (3ct 2st),0.792,1992,2002,NZ
1479,Sarfaraz Ahmed ,2007-2019,116,114,140,116,24,116,0,6 (6ct 0st),1.228,2007,2019,PAK
1480,SR Tendulkar ,1989-2012,463,456,140,140,0,0,140,4 (4ct 0st),0.307,1989,2012,INDIA
1481,LRPL Taylor ,2006-2019,228,224,137,137,0,0,137,4 (4ct 0st),0.611,2006,2019,NZ
1482,Younis Khan ,2000-2015,265,260,135,135,0,5,130,4 (4ct 0st),0.519,2000,2015,PAK
1483,SP Fleming ,1994-2007,280,276,133,133,0,0,133,4 (4ct 0st),0.481,1994,2007,NZ
1484,JH Kallis ,1996-2014,328,324,131,131,0,0,131,3 (3ct 0st),0.4039999999999999,1996,2014,SA
1485,M Muralitharan ,1993-2011,350,347,130,130,0,0,130,3 (3ct 0st),0.374,1993,2011,SL
1486,AR Border ,1979-1994,273,270,127,127,0,0,127,3 (3ct 0st),0.47,1979,1994,AUS
1487,Shahid Afridi ,1996-2015,398,392,127,127,0,0,127,2 (2ct 0st),0.3229999999999999,1996,2015,PAK
1488,Khaled Mashud ,1995-2006,126,126,126,91,35,91,0,5 (3ct 2st),1.0,1995,2006,BDESH
1489,TM Dilshan ,1999-2016,330,325,124,123,1,5,118,3 (3ct 0st),0.381,1999,2016,SL
1490,CH Gayle ,1999-2019,301,294,124,124,0,0,124,3 (3ct 0st),0.421,1999,2019,WI
1491,V Kohli ,2008-2019,242,240,124,124,0,0,124,3 (3ct 0st),0.516,2008,2019,INDIA
1492,RW Marsh ,1971-1984,92,92,124,120,4,120,0,5 (5ct 0st),1.347,1971,1984,AUS
1493,ST Jayasuriya ,1989-2011,445,441,123,123,0,0,123,3 (3ct 0st),0.278,1989,2011,SL
1494,CL Hooper ,1987-2003,227,225,120,120,0,0,120,4 (4ct 0st),0.5329999999999999,1987,2003,WI
1495,BC Lara ,1990-2007,299,296,120,120,0,0,120,3 (3ct 0st),0.405,1990,2007,WI
1496,L Ronchi ,2008-2017,85,83,117,105,12,105,0,4 (4ct 0st),1.409,2008,2017,AUS
1497,MS Wade ,2012-2017,94,94,117,108,9,108,0,5 (5ct 0st),1.244,2012,2017,AUS
1498,Inzamam-ul-Haq ,1991-2007,378,373,113,113,0,0,113,3 (3ct 0st),0.302,1991,2007,PAK
1499,SR Waugh ,1986-2002,325,324,111,111,0,0,111,3 (3ct 0st),0.342,1986,2002,AUS
1500,KC Sangakkara ,2000-2015,404,397,501,402,99,383,19,5 (4ct 1st),1.261,2000,2015,SL
1501,AC Gilchrist ,1996-2008,287,286,472,417,55,417,0,6 (6ct 0st),1.65,1996,2008,AUS
1502,MS Dhoni ,2004-2019,350,345,444,321,123,321,0,6 (5ct 1st),1.286,2004,2019,INDIA
1503,MV Boucher ,1998-2011,295,291,425,403,22,402,1,6 (6ct 0st),1.46,1998,2011,SA
1504,Moin Khan ,1990-2004,219,217,287,214,73,214,0,5 (5ct 0st),1.3219999999999998,1990,2004,PAK
1505,BB McCullum ,2002-2016,260,257,277,262,15,227,35,5 (5ct 0st),1.077,2002,2016,NZ
1506,IA Healy ,1988-1997,168,168,233,194,39,194,0,4 (4ct 0st),1.386,1988,1997,AUS
1507,Mushfiqur Rahim ,2006-2019,216,215,225,181,44,179,2,5 (5ct 0st),1.046,2006,2019,BDESH
1508,Rashid Latif ,1992-2003,166,164,220,182,38,182,0,5 (5ct 0st),1.341,1992,2003,PAK
1509,DPMD Jayawardene ,1998-2015,448,443,218,218,0,0,218,4 (4ct 0st),0.492,1998,2015,SL
1510,R Dravid ,1996-2011,344,341,210,196,14,72,124,4 (4ct 0st),0.615,1996,2011,INDIA
1511,RS Kaluwitharana ,1990-2004,189,188,207,132,75,131,1,5 (4ct 1st),1.101,1990,2004,SL
1512,PJL Dujon ,1981-1991,169,168,204,183,21,183,0,4 (4ct 0st),1.214,1981,1991,WI
1513,JC Buttler ,2012-2019,142,138,202,171,31,171,0,6 (6ct 0st),1.463,2012,2019,ENG
1514,RD Jacobs ,1996-2004,147,145,189,160,29,160,0,6 (5ct 1st),1.3030000000000002,1996,2004,WI
1515,Kamran Akmal ,2002-2017,157,154,188,157,31,156,1,5 (4ct 1st),1.22,2002,2017,PAK
1516,D Ramdin ,2005-2016,139,137,188,181,7,181,0,5 (5ct 0st),1.372,2005,2016,WI
1517,AB de Villiers ,2005-2018,228,223,181,176,5,93,83,5 (5ct 0st),0.8109999999999999,2005,2018,SA
1518,BJ Haddin ,2001-2015,126,124,181,170,11,170,0,5 (5ct 0st),1.459,2001,2015,AUS
1519,AJ Stewart ,1989-2003,170,169,174,159,15,148,11,6 (6ct 0st),1.029,1989,2003,ENG
1520,A Flower ,1992-2003,213,212,173,141,32,133,8,5 (5ct 0st),0.816,1992,2003,ZIM
1521,Q de Kock ,2013-2019,115,111,166,158,8,158,0,6 (5ct 1st),1.495,2013,2019,SA
1522,DJ Richardson ,1991-1998,122,121,165,148,17,148,0,5 (5ct 0st),1.3630000000000002,1991,1998,SA
1523,RT Ponting ,1995-2012,375,372,160,160,0,0,160,3 (3ct 0st),0.43,1995,2012,AUS
1524,M Azharuddin ,1985-2000,334,332,156,156,0,0,156,4 (4ct 0st),0.469,1985,2000,INDIA
1525,NR Mongia ,1994-2000,140,139,154,110,44,110,0,5 (4ct 1st),1.107,1994,2000,INDIA
1526,BRM Taylor ,2004-2019,193,193,154,125,29,96,29,5 (5ct 0st),0.797,2004,2019,ZIM
1527,T Taibu ,2001-2012,150,150,147,114,33,112,2,4 (4ct 0st),0.98,2001,2012,ZIM
1528,AC Parore ,1992-2002,179,178,141,116,25,111,5,5 (3ct 2st),0.792,1992,2002,NZ
1529,Sarfaraz Ahmed ,2007-2019,116,114,140,116,24,116,0,6 (6ct 0st),1.228,2007,2019,PAK
1530,SR Tendulkar ,1989-2012,463,456,140,140,0,0,140,4 (4ct 0st),0.307,1989,2012,INDIA
1531,LRPL Taylor ,2006-2019,228,224,137,137,0,0,137,4 (4ct 0st),0.611,2006,2019,NZ
1532,Younis Khan ,2000-2015,265,260,135,135,0,5,130,4 (4ct 0st),0.519,2000,2015,PAK
1533,SP Fleming ,1994-2007,280,276,133,133,0,0,133,4 (4ct 0st),0.481,1994,2007,NZ
1534,JH Kallis ,1996-2014,328,324,131,131,0,0,131,3 (3ct 0st),0.4039999999999999,1996,2014,SA
1535,M Muralitharan ,1993-2011,350,347,130,130,0,0,130,3 (3ct 0st),0.374,1993,2011,SL
1536,AR Border ,1979-1994,273,270,127,127,0,0,127,3 (3ct 0st),0.47,1979,1994,AUS
1537,Shahid Afridi ,1996-2015,398,392,127,127,0,0,127,2 (2ct 0st),0.3229999999999999,1996,2015,PAK
1538,Khaled Mashud ,1995-2006,126,126,126,91,35,91,0,5 (3ct 2st),1.0,1995,2006,BDESH
1539,TM Dilshan ,1999-2016,330,325,124,123,1,5,118,3 (3ct 0st),0.381,1999,2016,SL
1540,CH Gayle ,1999-2019,301,294,124,124,0,0,124,3 (3ct 0st),0.421,1999,2019,WI
1541,V Kohli ,2008-2019,242,240,124,124,0,0,124,3 (3ct 0st),0.516,2008,2019,INDIA
1542,RW Marsh ,1971-1984,92,92,124,120,4,120,0,5 (5ct 0st),1.347,1971,1984,AUS
1543,ST Jayasuriya ,1989-2011,445,441,123,123,0,0,123,3 (3ct 0st),0.278,1989,2011,SL
1544,CL Hooper ,1987-2003,227,225,120,120,0,0,120,4 (4ct 0st),0.5329999999999999,1987,2003,WI
1545,BC Lara ,1990-2007,299,296,120,120,0,0,120,3 (3ct 0st),0.405,1990,2007,WI
1546,L Ronchi ,2008-2017,85,83,117,105,12,105,0,4 (4ct 0st),1.409,2008,2017,AUS
1547,MS Wade ,2012-2017,94,94,117,108,9,108,0,5 (5ct 0st),1.244,2012,2017,AUS
1548,Inzamam-ul-Haq ,1991-2007,378,373,113,113,0,0,113,3 (3ct 0st),0.302,1991,2007,PAK
1549,SR Waugh ,1986-2002,325,324,111,111,0,0,111,3 (3ct 0st),0.342,1986,2002,AUS
1550,KC Sangakkara ,2000-2015,404,397,501,402,99,383,19,5 (4ct 1st),1.261,2000,2015,SL
1551,AC Gilchrist ,1996-2008,287,286,472,417,55,417,0,6 (6ct 0st),1.65,1996,2008,AUS
1552,MS Dhoni ,2004-2019,350,345,444,321,123,321,0,6 (5ct 1st),1.286,2004,2019,INDIA
1553,MV Boucher ,1998-2011,295,291,425,403,22,402,1,6 (6ct 0st),1.46,1998,2011,SA
1554,Moin Khan ,1990-2004,219,217,287,214,73,214,0,5 (5ct 0st),1.3219999999999998,1990,2004,PAK
1555,BB McCullum ,2002-2016,260,257,277,262,15,227,35,5 (5ct 0st),1.077,2002,2016,NZ
1556,IA Healy ,1988-1997,168,168,233,194,39,194,0,4 (4ct 0st),1.386,1988,1997,AUS
1557,Mushfiqur Rahim ,2006-2019,216,215,225,181,44,179,2,5 (5ct 0st),1.046,2006,2019,BDESH
1558,Rashid Latif ,1992-2003,166,164,220,182,38,182,0,5 (5ct 0st),1.341,1992,2003,PAK
1559,DPMD Jayawardene ,1998-2015,448,443,218,218,0,0,218,4 (4ct 0st),0.492,1998,2015,SL
1560,R Dravid ,1996-2011,344,341,210,196,14,72,124,4 (4ct 0st),0.615,1996,2011,INDIA
1561,RS Kaluwitharana ,1990-2004,189,188,207,132,75,131,1,5 (4ct 1st),1.101,1990,2004,SL
1562,PJL Dujon ,1981-1991,169,168,204,183,21,183,0,4 (4ct 0st),1.214,1981,1991,WI
1563,JC Buttler ,2012-2019,142,138,202,171,31,171,0,6 (6ct 0st),1.463,2012,2019,ENG
1564,RD Jacobs ,1996-2004,147,145,189,160,29,160,0,6 (5ct 1st),1.3030000000000002,1996,2004,WI
1565,Kamran Akmal ,2002-2017,157,154,188,157,31,156,1,5 (4ct 1st),1.22,2002,2017,PAK
1566,D Ramdin ,2005-2016,139,137,188,181,7,181,0,5 (5ct 0st),1.372,2005,2016,WI
1567,AB de Villiers ,2005-2018,228,223,181,176,5,93,83,5 (5ct 0st),0.8109999999999999,2005,2018,SA
1568,BJ Haddin ,2001-2015,126,124,181,170,11,170,0,5 (5ct 0st),1.459,2001,2015,AUS
1569,AJ Stewart ,1989-2003,170,169,174,159,15,148,11,6 (6ct 0st),1.029,1989,2003,ENG
1570,A Flower ,1992-2003,213,212,173,141,32,133,8,5 (5ct 0st),0.816,1992,2003,ZIM
1571,Q de Kock ,2013-2019,115,111,166,158,8,158,0,6 (5ct 1st),1.495,2013,2019,SA
1572,DJ Richardson ,1991-1998,122,121,165,148,17,148,0,5 (5ct 0st),1.3630000000000002,1991,1998,SA
1573,RT Ponting ,1995-2012,375,372,160,160,0,0,160,3 (3ct 0st),0.43,1995,2012,AUS
1574,M Azharuddin ,1985-2000,334,332,156,156,0,0,156,4 (4ct 0st),0.469,1985,2000,INDIA
1575,NR Mongia ,1994-2000,140,139,154,110,44,110,0,5 (4ct 1st),1.107,1994,2000,INDIA
1576,BRM Taylor ,2004-2019,193,193,154,125,29,96,29,5 (5ct 0st),0.797,2004,2019,ZIM
1577,T Taibu ,2001-2012,150,150,147,114,33,112,2,4 (4ct 0st),0.98,2001,2012,ZIM
1578,AC Parore ,1992-2002,179,178,141,116,25,111,5,5 (3ct 2st),0.792,1992,2002,NZ
1579,Sarfaraz Ahmed ,2007-2019,116,114,140,116,24,116,0,6 (6ct 0st),1.228,2007,2019,PAK
1580,SR Tendulkar ,1989-2012,463,456,140,140,0,0,140,4 (4ct 0st),0.307,1989,2012,INDIA
1581,LRPL Taylor ,2006-2019,228,224,137,137,0,0,137,4 (4ct 0st),0.611,2006,2019,NZ
1582,Younis Khan ,2000-2015,265,260,135,135,0,5,130,4 (4ct 0st),0.519,2000,2015,PAK
1583,SP Fleming ,1994-2007,280,276,133,133,0,0,133,4 (4ct 0st),0.481,1994,2007,NZ
1584,JH Kallis ,1996-2014,328,324,131,131,0,0,131,3 (3ct 0st),0.4039999999999999,1996,2014,SA
1585,M Muralitharan ,1993-2011,350,347,130,130,0,0,130,3 (3ct 0st),0.374,1993,2011,SL
1586,AR Border ,1979-1994,273,270,127,127,0,0,127,3 (3ct 0st),0.47,1979,1994,AUS
1587,Shahid Afridi ,1996-2015,398,392,127,127,0,0,127,2 (2ct 0st),0.3229999999999999,1996,2015,PAK
1588,Khaled Mashud ,1995-2006,126,126,126,91,35,91,0,5 (3ct 2st),1.0,1995,2006,BDESH
1589,TM Dilshan ,1999-2016,330,325,124,123,1,5,118,3 (3ct 0st),0.381,1999,2016,SL
1590,CH Gayle ,1999-2019,301,294,124,124,0,0,124,3 (3ct 0st),0.421,1999,2019,WI
1591,V Kohli ,2008-2019,242,240,124,124,0,0,124,3 (3ct 0st),0.516,2008,2019,INDIA
1592,RW Marsh ,1971-1984,92,92,124,120,4,120,0,5 (5ct 0st),1.347,1971,1984,AUS
1593,ST Jayasuriya ,1989-2011,445,441,123,123,0,0,123,3 (3ct 0st),0.278,1989,2011,SL
1594,CL Hooper ,1987-2003,227,225,120,120,0,0,120,4 (4ct 0st),0.5329999999999999,1987,2003,WI
1595,BC Lara ,1990-2007,299,296,120,120,0,0,120,3 (3ct 0st),0.405,1990,2007,WI
1596,L Ronchi ,2008-2017,85,83,117,105,12,105,0,4 (4ct 0st),1.409,2008,2017,AUS
1597,MS Wade ,2012-2017,94,94,117,108,9,108,0,5 (5ct 0st),1.244,2012,2017,AUS
1598,Inzamam-ul-Haq ,1991-2007,378,373,113,113,0,0,113,3 (3ct 0st),0.302,1991,2007,PAK
1599,SR Waugh ,1986-2002,325,324,111,111,0,0,111,3 (3ct 0st),0.342,1986,2002,AUS
1600,KC Sangakkara ,2000-2015,404,397,501,402,99,383,19,5 (4ct 1st),1.261,2000,2015,SL
1601,AC Gilchrist ,1996-2008,287,286,472,417,55,417,0,6 (6ct 0st),1.65,1996,2008,AUS
1602,MS Dhoni ,2004-2019,350,345,444,321,123,321,0,6 (5ct 1st),1.286,2004,2019,INDIA
1603,MV Boucher ,1998-2011,295,291,425,403,22,402,1,6 (6ct 0st),1.46,1998,2011,SA
1604,Moin Khan ,1990-2004,219,217,287,214,73,214,0,5 (5ct 0st),1.3219999999999998,1990,2004,PAK
1605,BB McCullum ,2002-2016,260,257,277,262,15,227,35,5 (5ct 0st),1.077,2002,2016,NZ
1606,IA Healy ,1988-1997,168,168,233,194,39,194,0,4 (4ct 0st),1.386,1988,1997,AUS
1607,Mushfiqur Rahim ,2006-2019,216,215,225,181,44,179,2,5 (5ct 0st),1.046,2006,2019,BDESH
1608,Rashid Latif ,1992-2003,166,164,220,182,38,182,0,5 (5ct 0st),1.341,1992,2003,PAK
1609,DPMD Jayawardene ,1998-2015,448,443,218,218,0,0,218,4 (4ct 0st),0.492,1998,2015,SL
1610,R Dravid ,1996-2011,344,341,210,196,14,72,124,4 (4ct 0st),0.615,1996,2011,INDIA
1611,RS Kaluwitharana ,1990-2004,189,188,207,132,75,131,1,5 (4ct 1st),1.101,1990,2004,SL
1612,PJL Dujon ,1981-1991,169,168,204,183,21,183,0,4 (4ct 0st),1.214,1981,1991,WI
1613,JC Buttler ,2012-2019,142,138,202,171,31,171,0,6 (6ct 0st),1.463,2012,2019,ENG
1614,RD Jacobs ,1996-2004,147,145,189,160,29,160,0,6 (5ct 1st),1.3030000000000002,1996,2004,WI
1615,Kamran Akmal ,2002-2017,157,154,188,157,31,156,1,5 (4ct 1st),1.22,2002,2017,PAK
1616,D Ramdin ,2005-2016,139,137,188,181,7,181,0,5 (5ct 0st),1.372,2005,2016,WI
1617,AB de Villiers ,2005-2018,228,223,181,176,5,93,83,5 (5ct 0st),0.8109999999999999,2005,2018,SA
1618,BJ Haddin ,2001-2015,126,124,181,170,11,170,0,5 (5ct 0st),1.459,2001,2015,AUS
1619,AJ Stewart ,1989-2003,170,169,174,159,15,148,11,6 (6ct 0st),1.029,1989,2003,ENG
1620,A Flower ,1992-2003,213,212,173,141,32,133,8,5 (5ct 0st),0.816,1992,2003,ZIM
1621,Q de Kock ,2013-2019,115,111,166,158,8,158,0,6 (5ct 1st),1.495,2013,2019,SA
1622,DJ Richardson ,1991-1998,122,121,165,148,17,148,0,5 (5ct 0st),1.3630000000000002,1991,1998,SA
1623,RT Ponting ,1995-2012,375,372,160,160,0,0,160,3 (3ct 0st),0.43,1995,2012,AUS
1624,M Azharuddin ,1985-2000,334,332,156,156,0,0,156,4 (4ct 0st),0.469,1985,2000,INDIA
1625,NR Mongia ,1994-2000,140,139,154,110,44,110,0,5 (4ct 1st),1.107,1994,2000,INDIA
1626,BRM Taylor ,2004-2019,193,193,154,125,29,96,29,5 (5ct 0st),0.797,2004,2019,ZIM
1627,T Taibu ,2001-2012,150,150,147,114,33,112,2,4 (4ct 0st),0.98,2001,2012,ZIM
1628,AC Parore ,1992-2002,179,178,141,116,25,111,5,5 (3ct 2st),0.792,1992,2002,NZ
1629,Sarfaraz Ahmed ,2007-2019,116,114,140,116,24,116,0,6 (6ct 0st),1.228,2007,2019,PAK
1630,SR Tendulkar ,1989-2012,463,456,140,140,0,0,140,4 (4ct 0st),0.307,1989,2012,INDIA
1631,LRPL Taylor ,2006-2019,228,224,137,137,0,0,137,4 (4ct 0st),0.611,2006,2019,NZ
1632,Younis Khan ,2000-2015,265,260,135,135,0,5,130,4 (4ct 0st),0.519,2000,2015,PAK
1633,SP Fleming ,1994-2007,280,276,133,133,0,0,133,4 (4ct 0st),0.481,1994,2007,NZ
1634,JH Kallis ,1996-2014,328,324,131,131,0,0,131,3 (3ct 0st),0.4039999999999999,1996,2014,SA
1635,M Muralitharan ,1993-2011,350,347,130,130,0,0,130,3 (3ct 0st),0.374,1993,2011,SL
1636,AR Border ,1979-1994,273,270,127,127,0,0,127,3 (3ct 0st),0.47,1979,1994,AUS
1637,Shahid Afridi ,1996-2015,398,392,127,127,0,0,127,2 (2ct 0st),0.3229999999999999,1996,2015,PAK
1638,Khaled Mashud ,1995-2006,126,126,126,91,35,91,0,5 (3ct 2st),1.0,1995,2006,BDESH
1639,TM Dilshan ,1999-2016,330,325,124,123,1,5,118,3 (3ct 0st),0.381,1999,2016,SL
1640,CH Gayle ,1999-2019,301,294,124,124,0,0,124,3 (3ct 0st),0.421,1999,2019,WI
1641,V Kohli ,2008-2019,242,240,124,124,0,0,124,3 (3ct 0st),0.516,2008,2019,INDIA
1642,RW Marsh ,1971-1984,92,92,124,120,4,120,0,5 (5ct 0st),1.347,1971,1984,AUS
1643,ST Jayasuriya ,1989-2011,445,441,123,123,0,0,123,3 (3ct 0st),0.278,1989,2011,SL
1644,CL Hooper ,1987-2003,227,225,120,120,0,0,120,4 (4ct 0st),0.5329999999999999,1987,2003,WI
1645,BC Lara ,1990-2007,299,296,120,120,0,0,120,3 (3ct 0st),0.405,1990,2007,WI
1646,L Ronchi ,2008-2017,85,83,117,105,12,105,0,4 (4ct 0st),1.409,2008,2017,AUS
1647,MS Wade ,2012-2017,94,94,117,108,9,108,0,5 (5ct 0st),1.244,2012,2017,AUS
1648,Inzamam-ul-Haq ,1991-2007,378,373,113,113,0,0,113,3 (3ct 0st),0.302,1991,2007,PAK
1649,SR Waugh ,1986-2002,325,324,111,111,0,0,111,3 (3ct 0st),0.342,1986,2002,AUS
1650,KC Sangakkara ,2000-2015,404,397,501,402,99,383,19,5 (4ct 1st),1.261,2000,2015,SL
1651,AC Gilchrist ,1996-2008,287,286,472,417,55,417,0,6 (6ct 0st),1.65,1996,2008,AUS
1652,MS Dhoni ,2004-2019,350,345,444,321,123,321,0,6 (5ct 1st),1.286,2004,2019,INDIA
1653,MV Boucher ,1998-2011,295,291,425,403,22,402,1,6 (6ct 0st),1.46,1998,2011,SA
1654,Moin Khan ,1990-2004,219,217,287,214,73,214,0,5 (5ct 0st),1.3219999999999998,1990,2004,PAK
1655,BB McCullum ,2002-2016,260,257,277,262,15,227,35,5 (5ct 0st),1.077,2002,2016,NZ
1656,IA Healy ,1988-1997,168,168,233,194,39,194,0,4 (4ct 0st),1.386,1988,1997,AUS
1657,Mushfiqur Rahim ,2006-2019,216,215,225,181,44,179,2,5 (5ct 0st),1.046,2006,2019,BDESH
1658,Rashid Latif ,1992-2003,166,164,220,182,38,182,0,5 (5ct 0st),1.341,1992,2003,PAK
1659,DPMD Jayawardene ,1998-2015,448,443,218,218,0,0,218,4 (4ct 0st),0.492,1998,2015,SL
1660,R Dravid ,1996-2011,344,341,210,196,14,72,124,4 (4ct 0st),0.615,1996,2011,INDIA
1661,RS Kaluwitharana ,1990-2004,189,188,207,132,75,131,1,5 (4ct 1st),1.101,1990,2004,SL
1662,PJL Dujon ,1981-1991,169,168,204,183,21,183,0,4 (4ct 0st),1.214,1981,1991,WI
1663,JC Buttler ,2012-2019,142,138,202,171,31,171,0,6 (6ct 0st),1.463,2012,2019,ENG
1664,RD Jacobs ,1996-2004,147,145,189,160,29,160,0,6 (5ct 1st),1.3030000000000002,1996,2004,WI
1665,Kamran Akmal ,2002-2017,157,154,188,157,31,156,1,5 (4ct 1st),1.22,2002,2017,PAK
1666,D Ramdin ,2005-2016,139,137,188,181,7,181,0,5 (5ct 0st),1.372,2005,2016,WI
1667,AB de Villiers ,2005-2018,228,223,181,176,5,93,83,5 (5ct 0st),0.8109999999999999,2005,2018,SA
1668,BJ Haddin ,2001-2015,126,124,181,170,11,170,0,5 (5ct 0st),1.459,2001,2015,AUS
1669,AJ Stewart ,1989-2003,170,169,174,159,15,148,11,6 (6ct 0st),1.029,1989,2003,ENG
1670,A Flower ,1992-2003,213,212,173,141,32,133,8,5 (5ct 0st),0.816,1992,2003,ZIM
1671,Q de Kock ,2013-2019,115,111,166,158,8,158,0,6 (5ct 1st),1.495,2013,2019,SA
1672,DJ Richardson ,1991-1998,122,121,165,148,17,148,0,5 (5ct 0st),1.3630000000000002,1991,1998,SA
1673,RT Ponting ,1995-2012,375,372,160,160,0,0,160,3 (3ct 0st),0.43,1995,2012,AUS
1674,M Azharuddin ,1985-2000,334,332,156,156,0,0,156,4 (4ct 0st),0.469,1985,2000,INDIA
1675,NR Mongia ,1994-2000,140,139,154,110,44,110,0,5 (4ct 1st),1.107,1994,2000,INDIA
1676,BRM Taylor ,2004-2019,193,193,154,125,29,96,29,5 (5ct 0st),0.797,2004,2019,ZIM
1677,T Taibu ,2001-2012,150,150,147,114,33,112,2,4 (4ct 0st),0.98,2001,2012,ZIM
1678,AC Parore ,1992-2002,179,178,141,116,25,111,5,5 (3ct 2st),0.792,1992,2002,NZ
1679,Sarfaraz Ahmed ,2007-2019,116,114,140,116,24,116,0,6 (6ct 0st),1.228,2007,2019,PAK
1680,SR Tendulkar ,1989-2012,463,456,140,140,0,0,140,4 (4ct 0st),0.307,1989,2012,INDIA
1681,LRPL Taylor ,2006-2019,228,224,137,137,0,0,137,4 (4ct 0st),0.611,2006,2019,NZ
1682,Younis Khan ,2000-2015,265,260,135,135,0,5,130,4 (4ct 0st),0.519,2000,2015,PAK
1683,SP Fleming ,1994-2007,280,276,133,133,0,0,133,4 (4ct 0st),0.481,1994,2007,NZ
1684,JH Kallis ,1996-2014,328,324,131,131,0,0,131,3 (3ct 0st),0.4039999999999999,1996,2014,SA
1685,M Muralitharan ,1993-2011,350,347,130,130,0,0,130,3 (3ct 0st),0.374,1993,2011,SL
1686,AR Border ,1979-1994,273,270,127,127,0,0,127,3 (3ct 0st),0.47,1979,1994,AUS
1687,Shahid Afridi ,1996-2015,398,392,127,127,0,0,127,2 (2ct 0st),0.3229999999999999,1996,2015,PAK
1688,Khaled Mashud ,1995-2006,126,126,126,91,35,91,0,5 (3ct 2st),1.0,1995,2006,BDESH
1689,TM Dilshan ,1999-2016,330,325,124,123,1,5,118,3 (3ct 0st),0.381,1999,2016,SL
1690,CH Gayle ,1999-2019,301,294,124,124,0,0,124,3 (3ct 0st),0.421,1999,2019,WI
1691,V Kohli ,2008-2019,242,240,124,124,0,0,124,3 (3ct 0st),0.516,2008,2019,INDIA
1692,RW Marsh ,1971-1984,92,92,124,120,4,120,0,5 (5ct 0st),1.347,1971,1984,AUS
1693,ST Jayasuriya ,1989-2011,445,441,123,123,0,0,123,3 (3ct 0st),0.278,1989,2011,SL
1694,CL Hooper ,1987-2003,227,225,120,120,0,0,120,4 (4ct 0st),0.5329999999999999,1987,2003,WI
1695,BC Lara ,1990-2007,299,296,120,120,0,0,120,3 (3ct 0st),0.405,1990,2007,WI
1696,L Ronchi ,2008-2017,85,83,117,105,12,105,0,4 (4ct 0st),1.409,2008,2017,AUS
1697,MS Wade ,2012-2017,94,94,117,108,9,108,0,5 (5ct 0st),1.244,2012,2017,AUS
1698,Inzamam-ul-Haq ,1991-2007,378,373,113,113,0,0,113,3 (3ct 0st),0.302,1991,2007,PAK
1699,SR Waugh ,1986-2002,325,324,111,111,0,0,111,3 (3ct 0st),0.342,1986,2002,AUS
1700,KC Sangakkara ,2000-2015,404,397,501,402,99,383,19,5 (4ct 1st),1.261,2000,2015,SL
1701,AC Gilchrist ,1996-2008,287,286,472,417,55,417,0,6 (6ct 0st),1.65,1996,2008,AUS
1702,MS Dhoni ,2004-2019,350,345,444,321,123,321,0,6 (5ct 1st),1.286,2004,2019,INDIA
1703,MV Boucher ,1998-2011,295,291,425,403,22,402,1,6 (6ct 0st),1.46,1998,2011,SA
1704,Moin Khan ,1990-2004,219,217,287,214,73,214,0,5 (5ct 0st),1.3219999999999998,1990,2004,PAK
1705,BB McCullum ,2002-2016,260,257,277,262,15,227,35,5 (5ct 0st),1.077,2002,2016,NZ
1706,IA Healy ,1988-1997,168,168,233,194,39,194,0,4 (4ct 0st),1.386,1988,1997,AUS
1707,Mushfiqur Rahim ,2006-2019,216,215,225,181,44,179,2,5 (5ct 0st),1.046,2006,2019,BDESH
1708,Rashid Latif ,1992-2003,166,164,220,182,38,182,0,5 (5ct 0st),1.341,1992,2003,PAK
1709,DPMD Jayawardene ,1998-2015,448,443,218,218,0,0,218,4 (4ct 0st),0.492,1998,2015,SL
1710,R Dravid ,1996-2011,344,341,210,196,14,72,124,4 (4ct 0st),0.615,1996,2011,INDIA
1711,RS Kaluwitharana ,1990-2004,189,188,207,132,75,131,1,5 (4ct 1st),1.101,1990,2004,SL
1712,PJL Dujon ,1981-1991,169,168,204,183,21,183,0,4 (4ct 0st),1.214,1981,1991,WI
1713,JC Buttler ,2012-2019,142,138,202,171,31,171,0,6 (6ct 0st),1.463,2012,2019,ENG
1714,RD Jacobs ,1996-2004,147,145,189,160,29,160,0,6 (5ct 1st),1.3030000000000002,1996,2004,WI
1715,Kamran Akmal ,2002-2017,157,154,188,157,31,156,1,5 (4ct 1st),1.22,2002,2017,PAK
1716,D Ramdin ,2005-2016,139,137,188,181,7,181,0,5 (5ct 0st),1.372,2005,2016,WI
1717,AB de Villiers ,2005-2018,228,223,181,176,5,93,83,5 (5ct 0st),0.8109999999999999,2005,2018,SA
1718,BJ Haddin ,2001-2015,126,124,181,170,11,170,0,5 (5ct 0st),1.459,2001,2015,AUS
1719,AJ Stewart ,1989-2003,170,169,174,159,15,148,11,6 (6ct 0st),1.029,1989,2003,ENG
1720,A Flower ,1992-2003,213,212,173,141,32,133,8,5 (5ct 0st),0.816,1992,2003,ZIM
1721,Q de Kock ,2013-2019,115,111,166,158,8,158,0,6 (5ct 1st),1.495,2013,2019,SA
1722,DJ Richardson ,1991-1998,122,121,165,148,17,148,0,5 (5ct 0st),1.3630000000000002,1991,1998,SA
1723,RT Ponting ,1995-2012,375,372,160,160,0,0,160,3 (3ct 0st),0.43,1995,2012,AUS
1724,M Azharuddin ,1985-2000,334,332,156,156,0,0,156,4 (4ct 0st),0.469,1985,2000,INDIA
1725,NR Mongia ,1994-2000,140,139,154,110,44,110,0,5 (4ct 1st),1.107,1994,2000,INDIA
1726,BRM Taylor ,2004-2019,193,193,154,125,29,96,29,5 (5ct 0st),0.797,2004,2019,ZIM
1727,T Taibu ,2001-2012,150,150,147,114,33,112,2,4 (4ct 0st),0.98,2001,2012,ZIM
1728,AC Parore ,1992-2002,179,178,141,116,25,111,5,5 (3ct 2st),0.792,1992,2002,NZ
1729,Sarfaraz Ahmed ,2007-2019,116,114,140,116,24,116,0,6 (6ct 0st),1.228,2007,2019,PAK
1730,SR Tendulkar ,1989-2012,463,456,140,140,0,0,140,4 (4ct 0st),0.307,1989,2012,INDIA
1731,LRPL Taylor ,2006-2019,228,224,137,137,0,0,137,4 (4ct 0st),0.611,2006,2019,NZ
1732,Younis Khan ,2000-2015,265,260,135,135,0,5,130,4 (4ct 0st),0.519,2000,2015,PAK
1733,SP Fleming ,1994-2007,280,276,133,133,0,0,133,4 (4ct 0st),0.481,1994,2007,NZ
1734,JH Kallis ,1996-2014,328,324,131,131,0,0,131,3 (3ct 0st),0.4039999999999999,1996,2014,SA
1735,M Muralitharan ,1993-2011,350,347,130,130,0,0,130,3 (3ct 0st),0.374,1993,2011,SL
1736,AR Border ,1979-1994,273,270,127,127,0,0,127,3 (3ct 0st),0.47,1979,1994,AUS
1737,Shahid Afridi ,1996-2015,398,392,127,127,0,0,127,2 (2ct 0st),0.3229999999999999,1996,2015,PAK
1738,Khaled Mashud ,1995-2006,126,126,126,91,35,91,0,5 (3ct 2st),1.0,1995,2006,BDESH
1739,TM Dilshan ,1999-2016,330,325,124,123,1,5,118,3 (3ct 0st),0.381,1999,2016,SL
1740,CH Gayle ,1999-2019,301,294,124,124,0,0,124,3 (3ct 0st),0.421,1999,2019,WI
1741,V Kohli ,2008-2019,242,240,124,124,0,0,124,3 (3ct 0st),0.516,2008,2019,INDIA
1742,RW Marsh ,1971-1984,92,92,124,120,4,120,0,5 (5ct 0st),1.347,1971,1984,AUS
1743,ST Jayasuriya ,1989-2011,445,441,123,123,0,0,123,3 (3ct 0st),0.278,1989,2011,SL
1744,CL Hooper ,1987-2003,227,225,120,120,0,0,120,4 (4ct 0st),0.5329999999999999,1987,2003,WI
1745,BC Lara ,1990-2007,299,296,120,120,0,0,120,3 (3ct 0st),0.405,1990,2007,WI
1746,L Ronchi ,2008-2017,85,83,117,105,12,105,0,4 (4ct 0st),1.409,2008,2017,AUS
1747,MS Wade ,2012-2017,94,94,117,108,9,108,0,5 (5ct 0st),1.244,2012,2017,AUS
1748,Inzamam-ul-Haq ,1991-2007,378,373,113,113,0,0,113,3 (3ct 0st),0.302,1991,2007,PAK
1749,SR Waugh ,1986-2002,325,324,111,111,0,0,111,3 (3ct 0st),0.342,1986,2002,AUS
1750,KC Sangakkara ,2000-2015,404,397,501,402,99,383,19,5 (4ct 1st),1.261,2000,2015,SL
1751,AC Gilchrist ,1996-2008,287,286,472,417,55,417,0,6 (6ct 0st),1.65,1996,2008,AUS
1752,MS Dhoni ,2004-2019,350,345,444,321,123,321,0,6 (5ct 1st),1.286,2004,2019,INDIA
1753,MV Boucher ,1998-2011,295,291,425,403,22,402,1,6 (6ct 0st),1.46,1998,2011,SA
1754,Moin Khan ,1990-2004,219,217,287,214,73,214,0,5 (5ct 0st),1.3219999999999998,1990,2004,PAK
1755,BB McCullum ,2002-2016,260,257,277,262,15,227,35,5 (5ct 0st),1.077,2002,2016,NZ
1756,IA Healy ,1988-1997,168,168,233,194,39,194,0,4 (4ct 0st),1.386,1988,1997,AUS
1757,Mushfiqur Rahim ,2006-2019,216,215,225,181,44,179,2,5 (5ct 0st),1.046,2006,2019,BDESH
1758,Rashid Latif ,1992-2003,166,164,220,182,38,182,0,5 (5ct 0st),1.341,1992,2003,PAK
1759,DPMD Jayawardene ,1998-2015,448,443,218,218,0,0,218,4 (4ct 0st),0.492,1998,2015,SL
1760,R Dravid ,1996-2011,344,341,210,196,14,72,124,4 (4ct 0st),0.615,1996,2011,INDIA
1761,RS Kaluwitharana ,1990-2004,189,188,207,132,75,131,1,5 (4ct 1st),1.101,1990,2004,SL
1762,PJL Dujon ,1981-1991,169,168,204,183,21,183,0,4 (4ct 0st),1.214,1981,1991,WI
1763,JC Buttler ,2012-2019,142,138,202,171,31,171,0,6 (6ct 0st),1.463,2012,2019,ENG
1764,RD Jacobs ,1996-2004,147,145,189,160,29,160,0,6 (5ct 1st),1.3030000000000002,1996,2004,WI
1765,Kamran Akmal ,2002-2017,157,154,188,157,31,156,1,5 (4ct 1st),1.22,2002,2017,PAK
1766,D Ramdin ,2005-2016,139,137,188,181,7,181,0,5 (5ct 0st),1.372,2005,2016,WI
1767,AB de Villiers ,2005-2018,228,223,181,176,5,93,83,5 (5ct 0st),0.8109999999999999,2005,2018,SA
1768,BJ Haddin ,2001-2015,126,124,181,170,11,170,0,5 (5ct 0st),1.459,2001,2015,AUS
1769,AJ Stewart ,1989-2003,170,169,174,159,15,148,11,6 (6ct 0st),1.029,1989,2003,ENG
1770,A Flower ,1992-2003,213,212,173,141,32,133,8,5 (5ct 0st),0.816,1992,2003,ZIM
1771,Q de Kock ,2013-2019,115,111,166,158,8,158,0,6 (5ct 1st),1.495,2013,2019,SA
1772,DJ Richardson ,1991-1998,122,121,165,148,17,148,0,5 (5ct 0st),1.3630000000000002,1991,1998,SA
1773,RT Ponting ,1995-2012,375,372,160,160,0,0,160,3 (3ct 0st),0.43,1995,2012,AUS
1774,M Azharuddin ,1985-2000,334,332,156,156,0,0,156,4 (4ct 0st),0.469,1985,2000,INDIA
1775,NR Mongia ,1994-2000,140,139,154,110,44,110,0,5 (4ct 1st),1.107,1994,2000,INDIA
1776,BRM Taylor ,2004-2019,193,193,154,125,29,96,29,5 (5ct 0st),0.797,2004,2019,ZIM
1777,T Taibu ,2001-2012,150,150,147,114,33,112,2,4 (4ct 0st),0.98,2001,2012,ZIM
1778,AC Parore ,1992-2002,179,178,141,116,25,111,5,5 (3ct 2st),0.792,1992,2002,NZ
1779,Sarfaraz Ahmed ,2007-2019,116,114,140,116,24,116,0,6 (6ct 0st),1.228,2007,2019,PAK
1780,SR Tendulkar ,1989-2012,463,456,140,140,0,0,140,4 (4ct 0st),0.307,1989,2012,INDIA
1781,LRPL Taylor ,2006-2019,228,224,137,137,0,0,137,4 (4ct 0st),0.611,2006,2019,NZ
1782,Younis Khan ,2000-2015,265,260,135,135,0,5,130,4 (4ct 0st),0.519,2000,2015,PAK
1783,SP Fleming ,1994-2007,280,276,133,133,0,0,133,4 (4ct 0st),0.481,1994,2007,NZ
1784,JH Kallis ,1996-2014,328,324,131,131,0,0,131,3 (3ct 0st),0.4039999999999999,1996,2014,SA
1785,M Muralitharan ,1993-2011,350,347,130,130,0,0,130,3 (3ct 0st),0.374,1993,2011,SL
1786,AR Border ,1979-1994,273,270,127,127,0,0,127,3 (3ct 0st),0.47,1979,1994,AUS
1787,Shahid Afridi ,1996-2015,398,392,127,127,0,0,127,2 (2ct 0st),0.3229999999999999,1996,2015,PAK
1788,Khaled Mashud ,1995-2006,126,126,126,91,35,91,0,5 (3ct 2st),1.0,1995,2006,BDESH
1789,TM Dilshan ,1999-2016,330,325,124,123,1,5,118,3 (3ct 0st),0.381,1999,2016,SL
1790,CH Gayle ,1999-2019,301,294,124,124,0,0,124,3 (3ct 0st),0.421,1999,2019,WI
1791,V Kohli ,2008-2019,242,240,124,124,0,0,124,3 (3ct 0st),0.516,2008,2019,INDIA
1792,RW Marsh ,1971-1984,92,92,124,120,4,120,0,5 (5ct 0st),1.347,1971,1984,AUS
1793,ST Jayasuriya ,1989-2011,445,441,123,123,0,0,123,3 (3ct 0st),0.278,1989,2011,SL
1794,CL Hooper ,1987-2003,227,225,120,120,0,0,120,4 (4ct 0st),0.5329999999999999,1987,2003,WI
1795,BC Lara ,1990-2007,299,296,120,120,0,0,120,3 (3ct 0st),0.405,1990,2007,WI
1796,L Ronchi ,2008-2017,85,83,117,105,12,105,0,4 (4ct 0st),1.409,2008,2017,AUS
1797,MS Wade ,2012-2017,94,94,117,108,9,108,0,5 (5ct 0st),1.244,2012,2017,AUS
1798,Inzamam-ul-Haq ,1991-2007,378,373,113,113,0,0,113,3 (3ct 0st),0.302,1991,2007,PAK
1799,SR Waugh ,1986-2002,325,324,111,111,0,0,111,3 (3ct 0st),0.342,1986,2002,AUS
1800,KC Sangakkara ,2000-2015,404,397,501,402,99,383,19,5 (4ct 1st),1.261,2000,2015,SL
1801,AC Gilchrist ,1996-2008,287,286,472,417,55,417,0,6 (6ct 0st),1.65,1996,2008,AUS
1802,MS Dhoni ,2004-2019,350,345,444,321,123,321,0,6 (5ct 1st),1.286,2004,2019,INDIA
1803,MV Boucher ,1998-2011,295,291,425,403,22,402,1,6 (6ct 0st),1.46,1998,2011,SA
1804,Moin Khan ,1990-2004,219,217,287,214,73,214,0,5 (5ct 0st),1.3219999999999998,1990,2004,PAK
1805,BB McCullum ,2002-2016,260,257,277,262,15,227,35,5 (5ct 0st),1.077,2002,2016,NZ
1806,IA Healy ,1988-1997,168,168,233,194,39,194,0,4 (4ct 0st),1.386,1988,1997,AUS
1807,Mushfiqur Rahim ,2006-2019,216,215,225,181,44,179,2,5 (5ct 0st),1.046,2006,2019,BDESH
1808,Rashid Latif ,1992-2003,166,164,220,182,38,182,0,5 (5ct 0st),1.341,1992,2003,PAK
1809,DPMD Jayawardene ,1998-2015,448,443,218,218,0,0,218,4 (4ct 0st),0.492,1998,2015,SL
1810,R Dravid ,1996-2011,344,341,210,196,14,72,124,4 (4ct 0st),0.615,1996,2011,INDIA
1811,RS Kaluwitharana ,1990-2004,189,188,207,132,75,131,1,5 (4ct 1st),1.101,1990,2004,SL
1812,PJL Dujon ,1981-1991,169,168,204,183,21,183,0,4 (4ct 0st),1.214,1981,1991,WI
1813,JC Buttler ,2012-2019,142,138,202,171,31,171,0,6 (6ct 0st),1.463,2012,2019,ENG
1814,RD Jacobs ,1996-2004,147,145,189,160,29,160,0,6 (5ct 1st),1.3030000000000002,1996,2004,WI
1815,Kamran Akmal ,2002-2017,157,154,188,157,31,156,1,5 (4ct 1st),1.22,2002,2017,PAK
1816,D Ramdin ,2005-2016,139,137,188,181,7,181,0,5 (5ct 0st),1.372,2005,2016,WI
1817,AB de Villiers ,2005-2018,228,223,181,176,5,93,83,5 (5ct 0st),0.8109999999999999,2005,2018,SA
1818,BJ Haddin ,2001-2015,126,124,181,170,11,170,0,5 (5ct 0st),1.459,2001,2015,AUS
1819,AJ Stewart ,1989-2003,170,169,174,159,15,148,11,6 (6ct 0st),1.029,1989,2003,ENG
1820,A Flower ,1992-2003,213,212,173,141,32,133,8,5 (5ct 0st),0.816,1992,2003,ZIM
1821,Q de Kock ,2013-2019,115,111,166,158,8,158,0,6 (5ct 1st),1.495,2013,2019,SA
1822,DJ Richardson ,1991-1998,122,121,165,148,17,148,0,5 (5ct 0st),1.3630000000000002,1991,1998,SA
1823,RT Ponting ,1995-2012,375,372,160,160,0,0,160,3 (3ct 0st),0.43,1995,2012,AUS
1824,M Azharuddin ,1985-2000,334,332,156,156,0,0,156,4 (4ct 0st),0.469,1985,2000,INDIA
1825,NR Mongia ,1994-2000,140,139,154,110,44,110,0,5 (4ct 1st),1.107,1994,2000,INDIA
1826,BRM Taylor ,2004-2019,193,193,154,125,29,96,29,5 (5ct 0st),0.797,2004,2019,ZIM
1827,T Taibu ,2001-2012,150,150,147,114,33,112,2,4 (4ct 0st),0.98,2001,2012,ZIM
1828,AC Parore ,1992-2002,179,178,141,116,25,111,5,5 (3ct 2st),0.792,1992,2002,NZ
1829,Sarfaraz Ahmed ,2007-2019,116,114,140,116,24,116,0,6 (6ct 0st),1.228,2007,2019,PAK
1830,SR Tendulkar ,1989-2012,463,456,140,140,0,0,140,4 (4ct 0st),0.307,1989,2012,INDIA
1831,LRPL Taylor ,2006-2019,228,224,137,137,0,0,137,4 (4ct 0st),0.611,2006,2019,NZ
1832,Younis Khan ,2000-2015,265,260,135,135,0,5,130,4 (4ct 0st),0.519,2000,2015,PAK
1833,SP Fleming ,1994-2007,280,276,133,133,0,0,133,4 (4ct 0st),0.481,1994,2007,NZ
1834,JH Kallis ,1996-2014,328,324,131,131,0,0,131,3 (3ct 0st),0.4039999999999999,1996,2014,SA
1835,M Muralitharan ,1993-2011,350,347,130,130,0,0,130,3 (3ct 0st),0.374,1993,2011,SL
1836,AR Border ,1979-1994,273,270,127,127,0,0,127,3 (3ct 0st),0.47,1979,1994,AUS
1837,Shahid Afridi ,1996-2015,398,392,127,127,0,0,127,2 (2ct 0st),0.3229999999999999,1996,2015,PAK
1838,Khaled Mashud ,1995-2006,126,126,126,91,35,91,0,5 (3ct 2st),1.0,1995,2006,BDESH
1839,TM Dilshan ,1999-2016,330,325,124,123,1,5,118,3 (3ct 0st),0.381,1999,2016,SL
1840,CH Gayle ,1999-2019,301,294,124,124,0,0,124,3 (3ct 0st),0.421,1999,2019,WI
1841,V Kohli ,2008-2019,242,240,124,124,0,0,124,3 (3ct 0st),0.516,2008,2019,INDIA
1842,RW Marsh ,1971-1984,92,92,124,120,4,120,0,5 (5ct 0st),1.347,1971,1984,AUS
1843,ST Jayasuriya ,1989-2011,445,441,123,123,0,0,123,3 (3ct 0st),0.278,1989,2011,SL
1844,CL Hooper ,1987-2003,227,225,120,120,0,0,120,4 (4ct 0st),0.5329999999999999,1987,2003,WI
1845,BC Lara ,1990-2007,299,296,120,120,0,0,120,3 (3ct 0st),0.405,1990,2007,WI
1846,L Ronchi ,2008-2017,85,83,117,105,12,105,0,4 (4ct 0st),1.409,2008,2017,AUS
1847,MS Wade ,2012-2017,94,94,117,108,9,108,0,5 (5ct 0st),1.244,2012,2017,AUS
1848,Inzamam-ul-Haq ,1991-2007,378,373,113,113,0,0,113,3 (3ct 0st),0.302,1991,2007,PAK
1849,SR Waugh ,1986-2002,325,324,111,111,0,0,111,3 (3ct 0st),0.342,1986,2002,AUS
1850,KC Sangakkara ,2000-2015,404,397,501,402,99,383,19,5 (4ct 1st),1.261,2000,2015,SL
1851,AC Gilchrist ,1996-2008,287,286,472,417,55,417,0,6 (6ct 0st),1.65,1996,2008,AUS
1852,MS Dhoni ,2004-2019,350,345,444,321,123,321,0,6 (5ct 1st),1.286,2004,2019,INDIA
1853,MV Boucher ,1998-2011,295,291,425,403,22,402,1,6 (6ct 0st),1.46,1998,2011,SA
1854,Moin Khan ,1990-2004,219,217,287,214,73,214,0,5 (5ct 0st),1.3219999999999998,1990,2004,PAK
1855,BB McCullum ,2002-2016,260,257,277,262,15,227,35,5 (5ct 0st),1.077,2002,2016,NZ
1856,IA Healy ,1988-1997,168,168,233,194,39,194,0,4 (4ct 0st),1.386,1988,1997,AUS
1857,Mushfiqur Rahim ,2006-2019,216,215,225,181,44,179,2,5 (5ct 0st),1.046,2006,2019,BDESH
1858,Rashid Latif ,1992-2003,166,164,220,182,38,182,0,5 (5ct 0st),1.341,1992,2003,PAK
1859,DPMD Jayawardene ,1998-2015,448,443,218,218,0,0,218,4 (4ct 0st),0.492,1998,2015,SL
1860,R Dravid ,1996-2011,344,341,210,196,14,72,124,4 (4ct 0st),0.615,1996,2011,INDIA
1861,RS Kaluwitharana ,1990-2004,189,188,207,132,75,131,1,5 (4ct 1st),1.101,1990,2004,SL
1862,PJL Dujon ,1981-1991,169,168,204,183,21,183,0,4 (4ct 0st),1.214,1981,1991,WI
1863,JC Buttler ,2012-2019,142,138,202,171,31,171,0,6 (6ct 0st),1.463,2012,2019,ENG
1864,RD Jacobs ,1996-2004,147,145,189,160,29,160,0,6 (5ct 1st),1.3030000000000002,1996,2004,WI
1865,Kamran Akmal ,2002-2017,157,154,188,157,31,156,1,5 (4ct 1st),1.22,2002,2017,PAK
1866,D Ramdin ,2005-2016,139,137,188,181,7,181,0,5 (5ct 0st),1.372,2005,2016,WI
1867,AB de Villiers ,2005-2018,228,223,181,176,5,93,83,5 (5ct 0st),0.8109999999999999,2005,2018,SA
1868,BJ Haddin ,2001-2015,126,124,181,170,11,170,0,5 (5ct 0st),1.459,2001,2015,AUS
1869,AJ Stewart ,1989-2003,170,169,174,159,15,148,11,6 (6ct 0st),1.029,1989,2003,ENG
1870,A Flower ,1992-2003,213,212,173,141,32,133,8,5 (5ct 0st),0.816,1992,2003,ZIM
1871,Q de Kock ,2013-2019,115,111,166,158,8,158,0,6 (5ct 1st),1.495,2013,2019,SA
1872,DJ Richardson ,1991-1998,122,121,165,148,17,148,0,5 (5ct 0st),1.3630000000000002,1991,1998,SA
1873,RT Ponting ,1995-2012,375,372,160,160,0,0,160,3 (3ct 0st),0.43,1995,2012,AUS
1874,M Azharuddin ,1985-2000,334,332,156,156,0,0,156,4 (4ct 0st),0.469,1985,2000,INDIA
1875,NR Mongia ,1994-2000,140,139,154,110,44,110,0,5 (4ct 1st),1.107,1994,2000,INDIA
1876,BRM Taylor ,2004-2019,193,193,154,125,29,96,29,5 (5ct 0st),0.797,2004,2019,ZIM
1877,T Taibu ,2001-2012,150,150,147,114,33,112,2,4 (4ct 0st),0.98,2001,2012,ZIM
1878,AC Parore ,1992-2002,179,178,141,116,25,111,5,5 (3ct 2st),0.792,1992,2002,NZ
1879,Sarfaraz Ahmed ,2007-2019,116,114,140,116,24,116,0,6 (6ct 0st),1.228,2007,2019,PAK
1880,SR Tendulkar ,1989-2012,463,456,140,140,0,0,140,4 (4ct 0st),0.307,1989,2012,INDIA
1881,LRPL Taylor ,2006-2019,228,224,137,137,0,0,137,4 (4ct 0st),0.611,2006,2019,NZ
1882,Younis Khan ,2000-2015,265,260,135,135,0,5,130,4 (4ct 0st),0.519,2000,2015,PAK
1883,SP Fleming ,1994-2007,280,276,133,133,0,0,133,4 (4ct 0st),0.481,1994,2007,NZ
1884,JH Kallis ,1996-2014,328,324,131,131,0,0,131,3 (3ct 0st),0.4039999999999999,1996,2014,SA
1885,M Muralitharan ,1993-2011,350,347,130,130,0,0,130,3 (3ct 0st),0.374,1993,2011,SL
1886,AR Border ,1979-1994,273,270,127,127,0,0,127,3 (3ct 0st),0.47,1979,1994,AUS
1887,Shahid Afridi ,1996-2015,398,392,127,127,0,0,127,2 (2ct 0st),0.3229999999999999,1996,2015,PAK
1888,Khaled Mashud ,1995-2006,126,126,126,91,35,91,0,5 (3ct 2st),1.0,1995,2006,BDESH
1889,TM Dilshan ,1999-2016,330,325,124,123,1,5,118,3 (3ct 0st),0.381,1999,2016,SL
1890,CH Gayle ,1999-2019,301,294,124,124,0,0,124,3 (3ct 0st),0.421,1999,2019,WI
1891,V Kohli ,2008-2019,242,240,124,124,0,0,124,3 (3ct 0st),0.516,2008,2019,INDIA
1892,RW Marsh ,1971-1984,92,92,124,120,4,120,0,5 (5ct 0st),1.347,1971,1984,AUS
1893,ST Jayasuriya ,1989-2011,445,441,123,123,0,0,123,3 (3ct 0st),0.278,1989,2011,SL
1894,CL Hooper ,1987-2003,227,225,120,120,0,0,120,4 (4ct 0st),0.5329999999999999,1987,2003,WI
1895,BC Lara ,1990-2007,299,296,120,120,0,0,120,3 (3ct 0st),0.405,1990,2007,WI
1896,L Ronchi ,2008-2017,85,83,117,105,12,105,0,4 (4ct 0st),1.409,2008,2017,AUS
1897,MS Wade ,2012-2017,94,94,117,108,9,108,0,5 (5ct 0st),1.244,2012,2017,AUS
1898,Inzamam-ul-Haq ,1991-2007,378,373,113,113,0,0,113,3 (3ct 0st),0.302,1991,2007,PAK
1899,SR Waugh ,1986-2002,325,324,111,111,0,0,111,3 (3ct 0st),0.342,1986,2002,AUS
1900,KC Sangakkara ,2000-2015,404,397,501,402,99,383,19,5 (4ct 1st),1.261,2000,2015,SL
1901,AC Gilchrist ,1996-2008,287,286,472,417,55,417,0,6 (6ct 0st),1.65,1996,2008,AUS
1902,MS Dhoni ,2004-2019,350,345,444,321,123,321,0,6 (5ct 1st),1.286,2004,2019,INDIA
1903,MV Boucher ,1998-2011,295,291,425,403,22,402,1,6 (6ct 0st),1.46,1998,2011,SA
1904,Moin Khan ,1990-2004,219,217,287,214,73,214,0,5 (5ct 0st),1.3219999999999998,1990,2004,PAK
1905,BB McCullum ,2002-2016,260,257,277,262,15,227,35,5 (5ct 0st),1.077,2002,2016,NZ
1906,IA Healy ,1988-1997,168,168,233,194,39,194,0,4 (4ct 0st),1.386,1988,1997,AUS
1907,Mushfiqur Rahim ,2006-2019,216,215,225,181,44,179,2,5 (5ct 0st),1.046,2006,2019,BDESH
1908,Rashid Latif ,1992-2003,166,164,220,182,38,182,0,5 (5ct 0st),1.341,1992,2003,PAK
1909,DPMD Jayawardene ,1998-2015,448,443,218,218,0,0,218,4 (4ct 0st),0.492,1998,2015,SL
1910,R Dravid ,1996-2011,344,341,210,196,14,72,124,4 (4ct 0st),0.615,1996,2011,INDIA
1911,RS Kaluwitharana ,1990-2004,189,188,207,132,75,131,1,5 (4ct 1st),1.101,1990,2004,SL
1912,PJL Dujon ,1981-1991,169,168,204,183,21,183,0,4 (4ct 0st),1.214,1981,1991,WI
1913,JC Buttler ,2012-2019,142,138,202,171,31,171,0,6 (6ct 0st),1.463,2012,2019,ENG
1914,RD Jacobs ,1996-2004,147,145,189,160,29,160,0,6 (5ct 1st),1.3030000000000002,1996,2004,WI
1915,Kamran Akmal ,2002-2017,157,154,188,157,31,156,1,5 (4ct 1st),1.22,2002,2017,PAK
1916,D Ramdin ,2005-2016,139,137,188,181,7,181,0,5 (5ct 0st),1.372,2005,2016,WI
1917,AB de Villiers ,2005-2018,228,223,181,176,5,93,83,5 (5ct 0st),0.8109999999999999,2005,2018,SA
1918,BJ Haddin ,2001-2015,126,124,181,170,11,170,0,5 (5ct 0st),1.459,2001,2015,AUS
1919,AJ Stewart ,1989-2003,170,169,174,159,15,148,11,6 (6ct 0st),1.029,1989,2003,ENG
1920,A Flower ,1992-2003,213,212,173,141,32,133,8,5 (5ct 0st),0.816,1992,2003,ZIM
1921,Q de Kock ,2013-2019,115,111,166,158,8,158,0,6 (5ct 1st),1.495,2013,2019,SA
1922,DJ Richardson ,1991-1998,122,121,165,148,17,148,0,5 (5ct 0st),1.3630000000000002,1991,1998,SA
1923,RT Ponting ,1995-2012,375,372,160,160,0,0,160,3 (3ct 0st),0.43,1995,2012,AUS
1924,M Azharuddin ,1985-2000,334,332,156,156,0,0,156,4 (4ct 0st),0.469,1985,2000,INDIA
1925,NR Mongia ,1994-2000,140,139,154,110,44,110,0,5 (4ct 1st),1.107,1994,2000,INDIA
1926,BRM Taylor ,2004-2019,193,193,154,125,29,96,29,5 (5ct 0st),0.797,2004,2019,ZIM
1927,T Taibu ,2001-2012,150,150,147,114,33,112,2,4 (4ct 0st),0.98,2001,2012,ZIM
1928,AC Parore ,1992-2002,179,178,141,116,25,111,5,5 (3ct 2st),0.792,1992,2002,NZ
1929,Sarfaraz Ahmed ,2007-2019,116,114,140,116,24,116,0,6 (6ct 0st),1.228,2007,2019,PAK
1930,SR Tendulkar ,1989-2012,463,456,140,140,0,0,140,4 (4ct 0st),0.307,1989,2012,INDIA
1931,LRPL Taylor ,2006-2019,228,224,137,137,0,0,137,4 (4ct 0st),0.611,2006,2019,NZ
1932,Younis Khan ,2000-2015,265,260,135,135,0,5,130,4 (4ct 0st),0.519,2000,2015,PAK
1933,SP Fleming ,1994-2007,280,276,133,133,0,0,133,4 (4ct 0st),0.481,1994,2007,NZ
1934,JH Kallis ,1996-2014,328,324,131,131,0,0,131,3 (3ct 0st),0.4039999999999999,1996,2014,SA
1935,M Muralitharan ,1993-2011,350,347,130,130,0,0,130,3 (3ct 0st),0.374,1993,2011,SL
1936,AR Border ,1979-1994,273,270,127,127,0,0,127,3 (3ct 0st),0.47,1979,1994,AUS
1937,Shahid Afridi ,1996-2015,398,392,127,127,0,0,127,2 (2ct 0st),0.3229999999999999,1996,2015,PAK
1938,Khaled Mashud ,1995-2006,126,126,126,91,35,91,0,5 (3ct 2st),1.0,1995,2006,BDESH
1939,TM Dilshan ,1999-2016,330,325,124,123,1,5,118,3 (3ct 0st),0.381,1999,2016,SL
1940,CH Gayle ,1999-2019,301,294,124,124,0,0,124,3 (3ct 0st),0.421,1999,2019,WI
1941,V Kohli ,2008-2019,242,240,124,124,0,0,124,3 (3ct 0st),0.516,2008,2019,INDIA
1942,RW Marsh ,1971-1984,92,92,124,120,4,120,0,5 (5ct 0st),1.347,1971,1984,AUS
1943,ST Jayasuriya ,1989-2011,445,441,123,123,0,0,123,3 (3ct 0st),0.278,1989,2011,SL
1944,CL Hooper ,1987-2003,227,225,120,120,0,0,120,4 (4ct 0st),0.5329999999999999,1987,2003,WI
1945,BC Lara ,1990-2007,299,296,120,120,0,0,120,3 (3ct 0st),0.405,1990,2007,WI
1946,L Ronchi ,2008-2017,85,83,117,105,12,105,0,4 (4ct 0st),1.409,2008,2017,AUS
1947,MS Wade ,2012-2017,94,94,117,108,9,108,0,5 (5ct 0st),1.244,2012,2017,AUS
1948,Inzamam-ul-Haq ,1991-2007,378,373,113,113,0,0,113,3 (3ct 0st),0.302,1991,2007,PAK
1949,SR Waugh ,1986-2002,325,324,111,111,0,0,111,3 (3ct 0st),0.342,1986,2002,AUS
1950,KC Sangakkara ,2000-2015,404,397,501,402,99,383,19,5 (4ct 1st),1.261,2000,2015,SL
1951,AC Gilchrist ,1996-2008,287,286,472,417,55,417,0,6 (6ct 0st),1.65,1996,2008,AUS
1952,MS Dhoni ,2004-2019,350,345,444,321,123,321,0,6 (5ct 1st),1.286,2004,2019,INDIA
1953,MV Boucher ,1998-2011,295,291,425,403,22,402,1,6 (6ct 0st),1.46,1998,2011,SA
1954,Moin Khan ,1990-2004,219,217,287,214,73,214,0,5 (5ct 0st),1.3219999999999998,1990,2004,PAK
1955,BB McCullum ,2002-2016,260,257,277,262,15,227,35,5 (5ct 0st),1.077,2002,2016,NZ
1956,IA Healy ,1988-1997,168,168,233,194,39,194,0,4 (4ct 0st),1.386,1988,1997,AUS
1957,Mushfiqur Rahim ,2006-2019,216,215,225,181,44,179,2,5 (5ct 0st),1.046,2006,2019,BDESH
1958,Rashid Latif ,1992-2003,166,164,220,182,38,182,0,5 (5ct 0st),1.341,1992,2003,PAK
1959,DPMD Jayawardene ,1998-2015,448,443,218,218,0,0,218,4 (4ct 0st),0.492,1998,2015,SL
1960,R Dravid ,1996-2011,344,341,210,196,14,72,124,4 (4ct 0st),0.615,1996,2011,INDIA
1961,RS Kaluwitharana ,1990-2004,189,188,207,132,75,131,1,5 (4ct 1st),1.101,1990,2004,SL
1962,PJL Dujon ,1981-1991,169,168,204,183,21,183,0,4 (4ct 0st),1.214,1981,1991,WI
1963,JC Buttler ,2012-2019,142,138,202,171,31,171,0,6 (6ct 0st),1.463,2012,2019,ENG
1964,RD Jacobs ,1996-2004,147,145,189,160,29,160,0,6 (5ct 1st),1.3030000000000002,1996,2004,WI
1965,Kamran Akmal ,2002-2017,157,154,188,157,31,156,1,5 (4ct 1st),1.22,2002,2017,PAK
1966,D Ramdin ,2005-2016,139,137,188,181,7,181,0,5 (5ct 0st),1.372,2005,2016,WI
1967,AB de Villiers ,2005-2018,228,223,181,176,5,93,83,5 (5ct 0st),0.8109999999999999,2005,2018,SA
1968,BJ Haddin ,2001-2015,126,124,181,170,11,170,0,5 (5ct 0st),1.459,2001,2015,AUS
1969,AJ Stewart ,1989-2003,170,169,174,159,15,148,11,6 (6ct 0st),1.029,1989,2003,ENG
1970,A Flower ,1992-2003,213,212,173,141,32,133,8,5 (5ct 0st),0.816,1992,2003,ZIM
1971,Q de Kock ,2013-2019,115,111,166,158,8,158,0,6 (5ct 1st),1.495,2013,2019,SA
1972,DJ Richardson ,1991-1998,122,121,165,148,17,148,0,5 (5ct 0st),1.3630000000000002,1991,1998,SA
1973,RT Ponting ,1995-2012,375,372,160,160,0,0,160,3 (3ct 0st),0.43,1995,2012,AUS
1974,M Azharuddin ,1985-2000,334,332,156,156,0,0,156,4 (4ct 0st),0.469,1985,2000,INDIA
1975,NR Mongia ,1994-2000,140,139,154,110,44,110,0,5 (4ct 1st),1.107,1994,2000,INDIA
1976,BRM Taylor ,2004-2019,193,193,154,125,29,96,29,5 (5ct 0st),0.797,2004,2019,ZIM
1977,T Taibu ,2001-2012,150,150,147,114,33,112,2,4 (4ct 0st),0.98,2001,2012,ZIM
1978,AC Parore ,1992-2002,179,178,141,116,25,111,5,5 (3ct 2st),0.792,1992,2002,NZ
1979,Sarfaraz Ahmed ,2007-2019,116,114,140,116,24,116,0,6 (6ct 0st),1.228,2007,2019,PAK
1980,SR Tendulkar ,1989-2012,463,456,140,140,0,0,140,4 (4ct 0st),0.307,1989,2012,INDIA
1981,LRPL Taylor ,2006-2019,228,224,137,137,0,0,137,4 (4ct 0st),0.611,2006,2019,NZ
1982,Younis Khan ,2000-2015,265,260,135,135,0,5,130,4 (4ct 0st),0.519,2000,2015,PAK
1983,SP Fleming ,1994-2007,280,276,133,133,0,0,133,4 (4ct 0st),0.481,1994,2007,NZ
1984,JH Kallis ,1996-2014,328,324,131,131,0,0,131,3 (3ct 0st),0.4039999999999999,1996,2014,SA
1985,M Muralitharan ,1993-2011,350,347,130,130,0,0,130,3 (3ct 0st),0.374,1993,2011,SL
1986,AR Border ,1979-1994,273,270,127,127,0,0,127,3 (3ct 0st),0.47,1979,1994,AUS
1987,Shahid Afridi ,1996-2015,398,392,127,127,0,0,127,2 (2ct 0st),0.3229999999999999,1996,2015,PAK
1988,Khaled Mashud ,1995-2006,126,126,126,91,35,91,0,5 (3ct 2st),1.0,1995,2006,BDESH
1989,TM Dilshan ,1999-2016,330,325,124,123,1,5,118,3 (3ct 0st),0.381,1999,2016,SL
1990,CH Gayle ,1999-2019,301,294,124,124,0,0,124,3 (3ct 0st),0.421,1999,2019,WI
1991,V Kohli ,2008-2019,242,240,124,124,0,0,124,3 (3ct 0st),0.516,2008,2019,INDIA
1992,RW Marsh ,1971-1984,92,92,124,120,4,120,0,5 (5ct 0st),1.347,1971,1984,AUS
1993,ST Jayasuriya ,1989-2011,445,441,123,123,0,0,123,3 (3ct 0st),0.278,1989,2011,SL
1994,CL Hooper ,1987-2003,227,225,120,120,0,0,120,4 (4ct 0st),0.5329999999999999,1987,2003,WI
1995,BC Lara ,1990-2007,299,296,120,120,0,0,120,3 (3ct 0st),0.405,1990,2007,WI
1996,L Ronchi ,2008-2017,85,83,117,105,12,105,0,4 (4ct 0st),1.409,2008,2017,AUS
1997,MS Wade ,2012-2017,94,94,117,108,9,108,0,5 (5ct 0st),1.244,2012,2017,AUS
1998,Inzamam-ul-Haq ,1991-2007,378,373,113,113,0,0,113,3 (3ct 0st),0.302,1991,2007,PAK
1999,SR Waugh ,1986-2002,325,324,111,111,0,0,111,3 (3ct 0st),0.342,1986,2002,AUS
2000,KC Sangakkara ,2000-2015,404,397,501,402,99,383,19,5 (4ct 1st),1.261,2000,2015,SL
2001,AC Gilchrist ,1996-2008,287,286,472,417,55,417,0,6 (6ct 0st),1.65,1996,2008,AUS
2002,MS Dhoni ,2004-2019,350,345,444,321,123,321,0,6 (5ct 1st),1.286,2004,2019,INDIA
2003,MV Boucher ,1998-2011,295,291,425,403,22,402,1,6 (6ct 0st),1.46,1998,2011,SA
2004,Moin Khan ,1990-2004,219,217,287,214,73,214,0,5 (5ct 0st),1.3219999999999998,1990,2004,PAK
2005,BB McCullum ,2002-2016,260,257,277,262,15,227,35,5 (5ct 0st),1.077,2002,2016,NZ
2006,IA Healy ,1988-1997,168,168,233,194,39,194,0,4 (4ct 0st),1.386,1988,1997,AUS
2007,Mushfiqur Rahim ,2006-2019,216,215,225,181,44,179,2,5 (5ct 0st),1.046,2006,2019,BDESH
2008,Rashid Latif ,1992-2003,166,164,220,182,38,182,0,5 (5ct 0st),1.341,1992,2003,PAK
2009,DPMD Jayawardene ,1998-2015,448,443,218,218,0,0,218,4 (4ct 0st),0.492,1998,2015,SL
2010,R Dravid ,1996-2011,344,341,210,196,14,72,124,4 (4ct 0st),0.615,1996,2011,INDIA
2011,RS Kaluwitharana ,1990-2004,189,188,207,132,75,131,1,5 (4ct 1st),1.101,1990,2004,SL
2012,PJL Dujon ,1981-1991,169,168,204,183,21,183,0,4 (4ct 0st),1.214,1981,1991,WI
2013,JC Buttler ,2012-2019,142,138,202,171,31,171,0,6 (6ct 0st),1.463,2012,2019,ENG
2014,RD Jacobs ,1996-2004,147,145,189,160,29,160,0,6 (5ct 1st),1.3030000000000002,1996,2004,WI
2015,Kamran Akmal ,2002-2017,157,154,188,157,31,156,1,5 (4ct 1st),1.22,2002,2017,PAK
2016,D Ramdin ,2005-2016,139,137,188,181,7,181,0,5 (5ct 0st),1.372,2005,2016,WI
2017,AB de Villiers ,2005-2018,228,223,181,176,5,93,83,5 (5ct 0st),0.8109999999999999,2005,2018,SA
2018,BJ Haddin ,2001-2015,126,124,181,170,11,170,0,5 (5ct 0st),1.459,2001,2015,AUS
2019,AJ Stewart ,1989-2003,170,169,174,159,15,148,11,6 (6ct 0st),1.029,1989,2003,ENG
2020,A Flower ,1992-2003,213,212,173,141,32,133,8,5 (5ct 0st),0.816,1992,2003,ZIM
2021,Q de Kock ,2013-2019,115,111,166,158,8,158,0,6 (5ct 1st),1.495,2013,2019,SA
2022,DJ Richardson ,1991-1998,122,121,165,148,17,148,0,5 (5ct 0st),1.3630000000000002,1991,1998,SA
2023,RT Ponting ,1995-2012,375,372,160,160,0,0,160,3 (3ct 0st),0.43,1995,2012,AUS
2024,M Azharuddin ,1985-2000,334,332,156,156,0,0,156,4 (4ct 0st),0.469,1985,2000,INDIA
2025,NR Mongia ,1994-2000,140,139,154,110,44,110,0,5 (4ct 1st),1.107,1994,2000,INDIA
2026,BRM Taylor ,2004-2019,193,193,154,125,29,96,29,5 (5ct 0st),0.797,2004,2019,ZIM
2027,T Taibu ,2001-2012,150,150,147,114,33,112,2,4 (4ct 0st),0.98,2001,2012,ZIM
2028,AC Parore ,1992-2002,179,178,141,116,25,111,5,5 (3ct 2st),0.792,1992,2002,NZ
2029,Sarfaraz Ahmed ,2007-2019,116,114,140,116,24,116,0,6 (6ct 0st),1.228,2007,2019,PAK
2030,SR Tendulkar ,1989-2012,463,456,140,140,0,0,140,4 (4ct 0st),0.307,1989,2012,INDIA
2031,LRPL Taylor ,2006-2019,228,224,137,137,0,0,137,4 (4ct 0st),0.611,2006,2019,NZ
2032,Younis Khan ,2000-2015,265,260,135,135,0,5,130,4 (4ct 0st),0.519,2000,2015,PAK
2033,SP Fleming ,1994-2007,280,276,133,133,0,0,133,4 (4ct 0st),0.481,1994,2007,NZ
2034,JH Kallis ,1996-2014,328,324,131,131,0,0,131,3 (3ct 0st),0.4039999999999999,1996,2014,SA
2035,M Muralitharan ,1993-2011,350,347,130,130,0,0,130,3 (3ct 0st),0.374,1993,2011,SL
2036,AR Border ,1979-1994,273,270,127,127,0,0,127,3 (3ct 0st),0.47,1979,1994,AUS
2037,Shahid Afridi ,1996-2015,398,392,127,127,0,0,127,2 (2ct 0st),0.3229999999999999,1996,2015,PAK
2038,Khaled Mashud ,1995-2006,126,126,126,91,35,91,0,5 (3ct 2st),1.0,1995,2006,BDESH
2039,TM Dilshan ,1999-2016,330,325,124,123,1,5,118,3 (3ct 0st),0.381,1999,2016,SL
2040,CH Gayle ,1999-2019,301,294,124,124,0,0,124,3 (3ct 0st),0.421,1999,2019,WI
2041,V Kohli ,2008-2019,242,240,124,124,0,0,124,3 (3ct 0st),0.516,2008,2019,INDIA
2042,RW Marsh ,1971-1984,92,92,124,120,4,120,0,5 (5ct 0st),1.347,1971,1984,AUS
2043,ST Jayasuriya ,1989-2011,445,441,123,123,0,0,123,3 (3ct 0st),0.278,1989,2011,SL
2044,CL Hooper ,1987-2003,227,225,120,120,0,0,120,4 (4ct 0st),0.5329999999999999,1987,2003,WI
2045,BC Lara ,1990-2007,299,296,120,120,0,0,120,3 (3ct 0st),0.405,1990,2007,WI
2046,L Ronchi ,2008-2017,85,83,117,105,12,105,0,4 (4ct 0st),1.409,2008,2017,AUS
2047,MS Wade ,2012-2017,94,94,117,108,9,108,0,5 (5ct 0st),1.244,2012,2017,AUS
2048,Inzamam-ul-Haq ,1991-2007,378,373,113,113,0,0,113,3 (3ct 0st),0.302,1991,2007,PAK
2049,SR Waugh ,1986-2002,325,324,111,111,0,0,111,3 (3ct 0st),0.342,1986,2002,AUS
2050,KC Sangakkara ,2000-2015,404,397,501,402,99,383,19,5 (4ct 1st),1.261,2000,2015,SL
2051,AC Gilchrist ,1996-2008,287,286,472,417,55,417,0,6 (6ct 0st),1.65,1996,2008,AUS
2052,MS Dhoni ,2004-2019,350,345,444,321,123,321,0,6 (5ct 1st),1.286,2004,2019,INDIA
2053,MV Boucher ,1998-2011,295,291,425,403,22,402,1,6 (6ct 0st),1.46,1998,2011,SA
2054,Moin Khan ,1990-2004,219,217,287,214,73,214,0,5 (5ct 0st),1.3219999999999998,1990,2004,PAK
2055,BB McCullum ,2002-2016,260,257,277,262,15,227,35,5 (5ct 0st),1.077,2002,2016,NZ
2056,IA Healy ,1988-1997,168,168,233,194,39,194,0,4 (4ct 0st),1.386,1988,1997,AUS
2057,Mushfiqur Rahim ,2006-2019,216,215,225,181,44,179,2,5 (5ct 0st),1.046,2006,2019,BDESH
2058,Rashid Latif ,1992-2003,166,164,220,182,38,182,0,5 (5ct 0st),1.341,1992,2003,PAK
2059,DPMD Jayawardene ,1998-2015,448,443,218,218,0,0,218,4 (4ct 0st),0.492,1998,2015,SL
2060,R Dravid ,1996-2011,344,341,210,196,14,72,124,4 (4ct 0st),0.615,1996,2011,INDIA
2061,RS Kaluwitharana ,1990-2004,189,188,207,132,75,131,1,5 (4ct 1st),1.101,1990,2004,SL
2062,PJL Dujon ,1981-1991,169,168,204,183,21,183,0,4 (4ct 0st),1.214,1981,1991,WI
2063,JC Buttler ,2012-2019,142,138,202,171,31,171,0,6 (6ct 0st),1.463,2012,2019,ENG
2064,RD Jacobs ,1996-2004,147,145,189,160,29,160,0,6 (5ct 1st),1.3030000000000002,1996,2004,WI
2065,Kamran Akmal ,2002-2017,157,154,188,157,31,156,1,5 (4ct 1st),1.22,2002,2017,PAK
2066,D Ramdin ,2005-2016,139,137,188,181,7,181,0,5 (5ct 0st),1.372,2005,2016,WI
2067,AB de Villiers ,2005-2018,228,223,181,176,5,93,83,5 (5ct 0st),0.8109999999999999,2005,2018,SA
2068,BJ Haddin ,2001-2015,126,124,181,170,11,170,0,5 (5ct 0st),1.459,2001,2015,AUS
2069,AJ Stewart ,1989-2003,170,169,174,159,15,148,11,6 (6ct 0st),1.029,1989,2003,ENG
2070,A Flower ,1992-2003,213,212,173,141,32,133,8,5 (5ct 0st),0.816,1992,2003,ZIM
2071,Q de Kock ,2013-2019,115,111,166,158,8,158,0,6 (5ct 1st),1.495,2013,2019,SA
2072,DJ Richardson ,1991-1998,122,121,165,148,17,148,0,5 (5ct 0st),1.3630000000000002,1991,1998,SA
2073,RT Ponting ,1995-2012,375,372,160,160,0,0,160,3 (3ct 0st),0.43,1995,2012,AUS
2074,M Azharuddin ,1985-2000,334,332,156,156,0,0,156,4 (4ct 0st),0.469,1985,2000,INDIA
2075,NR Mongia ,1994-2000,140,139,154,110,44,110,0,5 (4ct 1st),1.107,1994,2000,INDIA
2076,BRM Taylor ,2004-2019,193,193,154,125,29,96,29,5 (5ct 0st),0.797,2004,2019,ZIM
2077,T Taibu ,2001-2012,150,150,147,114,33,112,2,4 (4ct 0st),0.98,2001,2012,ZIM
2078,AC Parore ,1992-2002,179,178,141,116,25,111,5,5 (3ct 2st),0.792,1992,2002,NZ
2079,Sarfaraz Ahmed ,2007-2019,116,114,140,116,24,116,0,6 (6ct 0st),1.228,2007,2019,PAK
2080,SR Tendulkar ,1989-2012,463,456,140,140,0,0,140,4 (4ct 0st),0.307,1989,2012,INDIA
2081,LRPL Taylor ,2006-2019,228,224,137,137,0,0,137,4 (4ct 0st),0.611,2006,2019,NZ
2082,Younis Khan ,2000-2015,265,260,135,135,0,5,130,4 (4ct 0st),0.519,2000,2015,PAK
2083,SP Fleming ,1994-2007,280,276,133,133,0,0,133,4 (4ct 0st),0.481,1994,2007,NZ
2084,JH Kallis ,1996-2014,328,324,131,131,0,0,131,3 (3ct 0st),0.4039999999999999,1996,2014,SA
2085,M Muralitharan ,1993-2011,350,347,130,130,0,0,130,3 (3ct 0st),0.374,1993,2011,SL
2086,AR Border ,1979-1994,273,270,127,127,0,0,127,3 (3ct 0st),0.47,1979,1994,AUS
2087,Shahid Afridi ,1996-2015,398,392,127,127,0,0,127,2 (2ct 0st),0.3229999999999999,1996,2015,PAK
2088,Khaled Mashud ,1995-2006,126,126,126,91,35,91,0,5 (3ct 2st),1.0,1995,2006,BDESH
2089,TM Dilshan ,1999-2016,330,325,124,123,1,5,118,3 (3ct 0st),0.381,1999,2016,SL
2090,CH Gayle ,1999-2019,301,294,124,124,0,0,124,3 (3ct 0st),0.421,1999,2019,WI
2091,V Kohli ,2008-2019,242,240,124,124,0,0,124,3 (3ct 0st),0.516,2008,2019,INDIA
2092,RW Marsh ,1971-1984,92,92,124,120,4,120,0,5 (5ct 0st),1.347,1971,1984,AUS
2093,ST Jayasuriya ,1989-2011,445,441,123,123,0,0,123,3 (3ct 0st),0.278,1989,2011,SL
2094,CL Hooper ,1987-2003,227,225,120,120,0,0,120,4 (4ct 0st),0.5329999999999999,1987,2003,WI
2095,BC Lara ,1990-2007,299,296,120,120,0,0,120,3 (3ct 0st),0.405,1990,2007,WI
2096,L Ronchi ,2008-2017,85,83,117,105,12,105,0,4 (4ct 0st),1.409,2008,2017,AUS
2097,MS Wade ,2012-2017,94,94,117,108,9,108,0,5 (5ct 0st),1.244,2012,2017,AUS
2098,Inzamam-ul-Haq ,1991-2007,378,373,113,113,0,0,113,3 (3ct 0st),0.302,1991,2007,PAK
2099,SR Waugh ,1986-2002,325,324,111,111,0,0,111,3 (3ct 0st),0.342,1986,2002,AUS
2100,KC Sangakkara ,2000-2015,404,397,501,402,99,383,19,5 (4ct 1st),1.261,2000,2015,SL
2101,AC Gilchrist ,1996-2008,287,286,472,417,55,417,0,6 (6ct 0st),1.65,1996,2008,AUS
2102,MS Dhoni ,2004-2019,350,345,444,321,123,321,0,6 (5ct 1st),1.286,2004,2019,INDIA
2103,MV Boucher ,1998-2011,295,291,425,403,22,402,1,6 (6ct 0st),1.46,1998,2011,SA
2104,Moin Khan ,1990-2004,219,217,287,214,73,214,0,5 (5ct 0st),1.3219999999999998,1990,2004,PAK
2105,BB McCullum ,2002-2016,260,257,277,262,15,227,35,5 (5ct 0st),1.077,2002,2016,NZ
2106,IA Healy ,1988-1997,168,168,233,194,39,194,0,4 (4ct 0st),1.386,1988,1997,AUS
2107,Mushfiqur Rahim ,2006-2019,216,215,225,181,44,179,2,5 (5ct 0st),1.046,2006,2019,BDESH
2108,Rashid Latif ,1992-2003,166,164,220,182,38,182,0,5 (5ct 0st),1.341,1992,2003,PAK
2109,DPMD Jayawardene ,1998-2015,448,443,218,218,0,0,218,4 (4ct 0st),0.492,1998,2015,SL
2110,R Dravid ,1996-2011,344,341,210,196,14,72,124,4 (4ct 0st),0.615,1996,2011,INDIA
2111,RS Kaluwitharana ,1990-2004,189,188,207,132,75,131,1,5 (4ct 1st),1.101,1990,2004,SL
2112,PJL Dujon ,1981-1991,169,168,204,183,21,183,0,4 (4ct 0st),1.214,1981,1991,WI
2113,JC Buttler ,2012-2019,142,138,202,171,31,171,0,6 (6ct 0st),1.463,2012,2019,ENG
2114,RD Jacobs ,1996-2004,147,145,189,160,29,160,0,6 (5ct 1st),1.3030000000000002,1996,2004,WI
2115,Kamran Akmal ,2002-2017,157,154,188,157,31,156,1,5 (4ct 1st),1.22,2002,2017,PAK
2116,D Ramdin ,2005-2016,139,137,188,181,7,181,0,5 (5ct 0st),1.372,2005,2016,WI
2117,AB de Villiers ,2005-2018,228,223,181,176,5,93,83,5 (5ct 0st),0.8109999999999999,2005,2018,SA
2118,BJ Haddin ,2001-2015,126,124,181,170,11,170,0,5 (5ct 0st),1.459,2001,2015,AUS
2119,AJ Stewart ,1989-2003,170,169,174,159,15,148,11,6 (6ct 0st),1.029,1989,2003,ENG
2120,A Flower ,1992-2003,213,212,173,141,32,133,8,5 (5ct 0st),0.816,1992,2003,ZIM
2121,Q de Kock ,2013-2019,115,111,166,158,8,158,0,6 (5ct 1st),1.495,2013,2019,SA
2122,DJ Richardson ,1991-1998,122,121,165,148,17,148,0,5 (5ct 0st),1.3630000000000002,1991,1998,SA
2123,RT Ponting ,1995-2012,375,372,160,160,0,0,160,3 (3ct 0st),0.43,1995,2012,AUS
2124,M Azharuddin ,1985-2000,334,332,156,156,0,0,156,4 (4ct 0st),0.469,1985,2000,INDIA
2125,NR Mongia ,1994-2000,140,139,154,110,44,110,0,5 (4ct 1st),1.107,1994,2000,INDIA
2126,BRM Taylor ,2004-2019,193,193,154,125,29,96,29,5 (5ct 0st),0.797,2004,2019,ZIM
2127,T Taibu ,2001-2012,150,150,147,114,33,112,2,4 (4ct 0st),0.98,2001,2012,ZIM
2128,AC Parore ,1992-2002,179,178,141,116,25,111,5,5 (3ct 2st),0.792,1992,2002,NZ
2129,Sarfaraz Ahmed ,2007-2019,116,114,140,116,24,116,0,6 (6ct 0st),1.228,2007,2019,PAK
2130,SR Tendulkar ,1989-2012,463,456,140,140,0,0,140,4 (4ct 0st),0.307,1989,2012,INDIA
2131,LRPL Taylor ,2006-2019,228,224,137,137,0,0,137,4 (4ct 0st),0.611,2006,2019,NZ
2132,Younis Khan ,2000-2015,265,260,135,135,0,5,130,4 (4ct 0st),0.519,2000,2015,PAK
2133,SP Fleming ,1994-2007,280,276,133,133,0,0,133,4 (4ct 0st),0.481,1994,2007,NZ
2134,JH Kallis ,1996-2014,328,324,131,131,0,0,131,3 (3ct 0st),0.4039999999999999,1996,2014,SA
2135,M Muralitharan ,1993-2011,350,347,130,130,0,0,130,3 (3ct 0st),0.374,1993,2011,SL
2136,AR Border ,1979-1994,273,270,127,127,0,0,127,3 (3ct 0st),0.47,1979,1994,AUS
2137,Shahid Afridi ,1996-2015,398,392,127,127,0,0,127,2 (2ct 0st),0.3229999999999999,1996,2015,PAK
2138,Khaled Mashud ,1995-2006,126,126,126,91,35,91,0,5 (3ct 2st),1.0,1995,2006,BDESH
2139,TM Dilshan ,1999-2016,330,325,124,123,1,5,118,3 (3ct 0st),0.381,1999,2016,SL
2140,CH Gayle ,1999-2019,301,294,124,124,0,0,124,3 (3ct 0st),0.421,1999,2019,WI
2141,V Kohli ,2008-2019,242,240,124,124,0,0,124,3 (3ct 0st),0.516,2008,2019,INDIA
2142,RW Marsh ,1971-1984,92,92,124,120,4,120,0,5 (5ct 0st),1.347,1971,1984,AUS
2143,ST Jayasuriya ,1989-2011,445,441,123,123,0,0,123,3 (3ct 0st),0.278,1989,2011,SL
2144,CL Hooper ,1987-2003,227,225,120,120,0,0,120,4 (4ct 0st),0.5329999999999999,1987,2003,WI
2145,BC Lara ,1990-2007,299,296,120,120,0,0,120,3 (3ct 0st),0.405,1990,2007,WI
2146,L Ronchi ,2008-2017,85,83,117,105,12,105,0,4 (4ct 0st),1.409,2008,2017,AUS
2147,MS Wade ,2012-2017,94,94,117,108,9,108,0,5 (5ct 0st),1.244,2012,2017,AUS
2148,Inzamam-ul-Haq ,1991-2007,378,373,113,113,0,0,113,3 (3ct 0st),0.302,1991,2007,PAK
2149,SR Waugh ,1986-2002,325,324,111,111,0,0,111,3 (3ct 0st),0.342,1986,2002,AUS
2150,KC Sangakkara ,2000-2015,404,397,501,402,99,383,19,5 (4ct 1st),1.261,2000,2015,SL
2151,AC Gilchrist ,1996-2008,287,286,472,417,55,417,0,6 (6ct 0st),1.65,1996,2008,AUS
2152,MS Dhoni ,2004-2019,350,345,444,321,123,321,0,6 (5ct 1st),1.286,2004,2019,INDIA
2153,MV Boucher ,1998-2011,295,291,425,403,22,402,1,6 (6ct 0st),1.46,1998,2011,SA
2154,Moin Khan ,1990-2004,219,217,287,214,73,214,0,5 (5ct 0st),1.3219999999999998,1990,2004,PAK
2155,BB McCullum ,2002-2016,260,257,277,262,15,227,35,5 (5ct 0st),1.077,2002,2016,NZ
2156,IA Healy ,1988-1997,168,168,233,194,39,194,0,4 (4ct 0st),1.386,1988,1997,AUS
2157,Mushfiqur Rahim ,2006-2019,216,215,225,181,44,179,2,5 (5ct 0st),1.046,2006,2019,BDESH
2158,Rashid Latif ,1992-2003,166,164,220,182,38,182,0,5 (5ct 0st),1.341,1992,2003,PAK
2159,DPMD Jayawardene ,1998-2015,448,443,218,218,0,0,218,4 (4ct 0st),0.492,1998,2015,SL
2160,R Dravid ,1996-2011,344,341,210,196,14,72,124,4 (4ct 0st),0.615,1996,2011,INDIA
2161,RS Kaluwitharana ,1990-2004,189,188,207,132,75,131,1,5 (4ct 1st),1.101,1990,2004,SL
2162,PJL Dujon ,1981-1991,169,168,204,183,21,183,0,4 (4ct 0st),1.214,1981,1991,WI
2163,JC Buttler ,2012-2019,142,138,202,171,31,171,0,6 (6ct 0st),1.463,2012,2019,ENG
2164,RD Jacobs ,1996-2004,147,145,189,160,29,160,0,6 (5ct 1st),1.3030000000000002,1996,2004,WI
2165,Kamran Akmal ,2002-2017,157,154,188,157,31,156,1,5 (4ct 1st),1.22,2002,2017,PAK
2166,D Ramdin ,2005-2016,139,137,188,181,7,181,0,5 (5ct 0st),1.372,2005,2016,WI
2167,AB de Villiers ,2005-2018,228,223,181,176,5,93,83,5 (5ct 0st),0.8109999999999999,2005,2018,SA
2168,BJ Haddin ,2001-2015,126,124,181,170,11,170,0,5 (5ct 0st),1.459,2001,2015,AUS
2169,AJ Stewart ,1989-2003,170,169,174,159,15,148,11,6 (6ct 0st),1.029,1989,2003,ENG
2170,A Flower ,1992-2003,213,212,173,141,32,133,8,5 (5ct 0st),0.816,1992,2003,ZIM
2171,Q de Kock ,2013-2019,115,111,166,158,8,158,0,6 (5ct 1st),1.495,2013,2019,SA
2172,DJ Richardson ,1991-1998,122,121,165,148,17,148,0,5 (5ct 0st),1.3630000000000002,1991,1998,SA
2173,RT Ponting ,1995-2012,375,372,160,160,0,0,160,3 (3ct 0st),0.43,1995,2012,AUS
2174,M Azharuddin ,1985-2000,334,332,156,156,0,0,156,4 (4ct 0st),0.469,1985,2000,INDIA
2175,NR Mongia ,1994-2000,140,139,154,110,44,110,0,5 (4ct 1st),1.107,1994,2000,INDIA
2176,BRM Taylor ,2004-2019,193,193,154,125,29,96,29,5 (5ct 0st),0.797,2004,2019,ZIM
2177,T Taibu ,2001-2012,150,150,147,114,33,112,2,4 (4ct 0st),0.98,2001,2012,ZIM
2178,AC Parore ,1992-2002,179,178,141,116,25,111,5,5 (3ct 2st),0.792,1992,2002,NZ
2179,Sarfaraz Ahmed ,2007-2019,116,114,140,116,24,116,0,6 (6ct 0st),1.228,2007,2019,PAK
2180,SR Tendulkar ,1989-2012,463,456,140,140,0,0,140,4 (4ct 0st),0.307,1989,2012,INDIA
2181,LRPL Taylor ,2006-2019,228,224,137,137,0,0,137,4 (4ct 0st),0.611,2006,2019,NZ
2182,Younis Khan ,2000-2015,265,260,135,135,0,5,130,4 (4ct 0st),0.519,2000,2015,PAK
2183,SP Fleming ,1994-2007,280,276,133,133,0,0,133,4 (4ct 0st),0.481,1994,2007,NZ
2184,JH Kallis ,1996-2014,328,324,131,131,0,0,131,3 (3ct 0st),0.4039999999999999,1996,2014,SA
2185,M Muralitharan ,1993-2011,350,347,130,130,0,0,130,3 (3ct 0st),0.374,1993,2011,SL
2186,AR Border ,1979-1994,273,270,127,127,0,0,127,3 (3ct 0st),0.47,1979,1994,AUS
2187,Shahid Afridi ,1996-2015,398,392,127,127,0,0,127,2 (2ct 0st),0.3229999999999999,1996,2015,PAK
2188,Khaled Mashud ,1995-2006,126,126,126,91,35,91,0,5 (3ct 2st),1.0,1995,2006,BDESH
2189,TM Dilshan ,1999-2016,330,325,124,123,1,5,118,3 (3ct 0st),0.381,1999,2016,SL
2190,CH Gayle ,1999-2019,301,294,124,124,0,0,124,3 (3ct 0st),0.421,1999,2019,WI
2191,V Kohli ,2008-2019,242,240,124,124,0,0,124,3 (3ct 0st),0.516,2008,2019,INDIA
2192,RW Marsh ,1971-1984,92,92,124,120,4,120,0,5 (5ct 0st),1.347,1971,1984,AUS
2193,ST Jayasuriya ,1989-2011,445,441,123,123,0,0,123,3 (3ct 0st),0.278,1989,2011,SL
2194,CL Hooper ,1987-2003,227,225,120,120,0,0,120,4 (4ct 0st),0.5329999999999999,1987,2003,WI
2195,BC Lara ,1990-2007,299,296,120,120,0,0,120,3 (3ct 0st),0.405,1990,2007,WI
2196,L Ronchi ,2008-2017,85,83,117,105,12,105,0,4 (4ct 0st),1.409,2008,2017,AUS
2197,MS Wade ,2012-2017,94,94,117,108,9,108,0,5 (5ct 0st),1.244,2012,2017,AUS
2198,Inzamam-ul-Haq ,1991-2007,378,373,113,113,0,0,113,3 (3ct 0st),0.302,1991,2007,PAK
2199,SR Waugh ,1986-2002,325,324,111,111,0,0,111,3 (3ct 0st),0.342,1986,2002,AUS
2200,KC Sangakkara ,2000-2015,404,397,501,402,99,383,19,5 (4ct 1st),1.261,2000,2015,SL
2201,AC Gilchrist ,1996-2008,287,286,472,417,55,417,0,6 (6ct 0st),1.65,1996,2008,AUS
2202,MS Dhoni ,2004-2019,350,345,444,321,123,321,0,6 (5ct 1st),1.286,2004,2019,INDIA
2203,MV Boucher ,1998-2011,295,291,425,403,22,402,1,6 (6ct 0st),1.46,1998,2011,SA
2204,Moin Khan ,1990-2004,219,217,287,214,73,214,0,5 (5ct 0st),1.3219999999999998,1990,2004,PAK
2205,BB McCullum ,2002-2016,260,257,277,262,15,227,35,5 (5ct 0st),1.077,2002,2016,NZ
2206,IA Healy ,1988-1997,168,168,233,194,39,194,0,4 (4ct 0st),1.386,1988,1997,AUS
2207,Mushfiqur Rahim ,2006-2019,216,215,225,181,44,179,2,5 (5ct 0st),1.046,2006,2019,BDESH
2208,Rashid Latif ,1992-2003,166,164,220,182,38,182,0,5 (5ct 0st),1.341,1992,2003,PAK
2209,DPMD Jayawardene ,1998-2015,448,443,218,218,0,0,218,4 (4ct 0st),0.492,1998,2015,SL
2210,R Dravid ,1996-2011,344,341,210,196,14,72,124,4 (4ct 0st),0.615,1996,2011,INDIA
2211,RS Kaluwitharana ,1990-2004,189,188,207,132,75,131,1,5 (4ct 1st),1.101,1990,2004,SL
2212,PJL Dujon ,1981-1991,169,168,204,183,21,183,0,4 (4ct 0st),1.214,1981,1991,WI
2213,JC Buttler ,2012-2019,142,138,202,171,31,171,0,6 (6ct 0st),1.463,2012,2019,ENG
2214,RD Jacobs ,1996-2004,147,145,189,160,29,160,0,6 (5ct 1st),1.3030000000000002,1996,2004,WI
2215,Kamran Akmal ,2002-2017,157,154,188,157,31,156,1,5 (4ct 1st),1.22,2002,2017,PAK
2216,D Ramdin ,2005-2016,139,137,188,181,7,181,0,5 (5ct 0st),1.372,2005,2016,WI
2217,AB de Villiers ,2005-2018,228,223,181,176,5,93,83,5 (5ct 0st),0.8109999999999999,2005,2018,SA
2218,BJ Haddin ,2001-2015,126,124,181,170,11,170,0,5 (5ct 0st),1.459,2001,2015,AUS
2219,AJ Stewart ,1989-2003,170,169,174,159,15,148,11,6 (6ct 0st),1.029,1989,2003,ENG
2220,A Flower ,1992-2003,213,212,173,141,32,133,8,5 (5ct 0st),0.816,1992,2003,ZIM
2221,Q de Kock ,2013-2019,115,111,166,158,8,158,0,6 (5ct 1st),1.495,2013,2019,SA
2222,DJ Richardson ,1991-1998,122,121,165,148,17,148,0,5 (5ct 0st),1.3630000000000002,1991,1998,SA
2223,RT Ponting ,1995-2012,375,372,160,160,0,0,160,3 (3ct 0st),0.43,1995,2012,AUS
2224,M Azharuddin ,1985-2000,334,332,156,156,0,0,156,4 (4ct 0st),0.469,1985,2000,INDIA
2225,NR Mongia ,1994-2000,140,139,154,110,44,110,0,5 (4ct 1st),1.107,1994,2000,INDIA
2226,BRM Taylor ,2004-2019,193,193,154,125,29,96,29,5 (5ct 0st),0.797,2004,2019,ZIM
2227,T Taibu ,2001-2012,150,150,147,114,33,112,2,4 (4ct 0st),0.98,2001,2012,ZIM
2228,AC Parore ,1992-2002,179,178,141,116,25,111,5,5 (3ct 2st),0.792,1992,2002,NZ
2229,Sarfaraz Ahmed ,2007-2019,116,114,140,116,24,116,0,6 (6ct 0st),1.228,2007,2019,PAK
2230,SR Tendulkar ,1989-2012,463,456,140,140,0,0,140,4 (4ct 0st),0.307,1989,2012,INDIA
2231,LRPL Taylor ,2006-2019,228,224,137,137,0,0,137,4 (4ct 0st),0.611,2006,2019,NZ
2232,Younis Khan ,2000-2015,265,260,135,135,0,5,130,4 (4ct 0st),0.519,2000,2015,PAK
2233,SP Fleming ,1994-2007,280,276,133,133,0,0,133,4 (4ct 0st),0.481,1994,2007,NZ
2234,JH Kallis ,1996-2014,328,324,131,131,0,0,131,3 (3ct 0st),0.4039999999999999,1996,2014,SA
2235,M Muralitharan ,1993-2011,350,347,130,130,0,0,130,3 (3ct 0st),0.374,1993,2011,SL
2236,AR Border ,1979-1994,273,270,127,127,0,0,127,3 (3ct 0st),0.47,1979,1994,AUS
2237,Shahid Afridi ,1996-2015,398,392,127,127,0,0,127,2 (2ct 0st),0.3229999999999999,1996,2015,PAK
2238,Khaled Mashud ,1995-2006,126,126,126,91,35,91,0,5 (3ct 2st),1.0,1995,2006,BDESH
2239,TM Dilshan ,1999-2016,330,325,124,123,1,5,118,3 (3ct 0st),0.381,1999,2016,SL
2240,CH Gayle ,1999-2019,301,294,124,124,0,0,124,3 (3ct 0st),0.421,1999,2019,WI
2241,V Kohli ,2008-2019,242,240,124,124,0,0,124,3 (3ct 0st),0.516,2008,2019,INDIA
2242,RW Marsh ,1971-1984,92,92,124,120,4,120,0,5 (5ct 0st),1.347,1971,1984,AUS
2243,ST Jayasuriya ,1989-2011,445,441,123,123,0,0,123,3 (3ct 0st),0.278,1989,2011,SL
2244,CL Hooper ,1987-2003,227,225,120,120,0,0,120,4 (4ct 0st),0.5329999999999999,1987,2003,WI
2245,BC Lara ,1990-2007,299,296,120,120,0,0,120,3 (3ct 0st),0.405,1990,2007,WI
2246,L Ronchi ,2008-2017,85,83,117,105,12,105,0,4 (4ct 0st),1.409,2008,2017,AUS
2247,MS Wade ,2012-2017,94,94,117,108,9,108,0,5 (5ct 0st),1.244,2012,2017,AUS
2248,Inzamam-ul-Haq ,1991-2007,378,373,113,113,0,0,113,3 (3ct 0st),0.302,1991,2007,PAK
2249,SR Waugh ,1986-2002,325,324,111,111,0,0,111,3 (3ct 0st),0.342,1986,2002,AUS
2250,KC Sangakkara ,2000-2015,404,397,501,402,99,383,19,5 (4ct 1st),1.261,2000,2015,SL
2251,AC Gilchrist ,1996-2008,287,286,472,417,55,417,0,6 (6ct 0st),1.65,1996,2008,AUS
2252,MS Dhoni ,2004-2019,350,345,444,321,123,321,0,6 (5ct 1st),1.286,2004,2019,INDIA
2253,MV Boucher ,1998-2011,295,291,425,403,22,402,1,6 (6ct 0st),1.46,1998,2011,SA
2254,Moin Khan ,1990-2004,219,217,287,214,73,214,0,5 (5ct 0st),1.3219999999999998,1990,2004,PAK
2255,BB McCullum ,2002-2016,260,257,277,262,15,227,35,5 (5ct 0st),1.077,2002,2016,NZ
2256,IA Healy ,1988-1997,168,168,233,194,39,194,0,4 (4ct 0st),1.386,1988,1997,AUS
2257,Mushfiqur Rahim ,2006-2019,216,215,225,181,44,179,2,5 (5ct 0st),1.046,2006,2019,BDESH
2258,Rashid Latif ,1992-2003,166,164,220,182,38,182,0,5 (5ct 0st),1.341,1992,2003,PAK
2259,DPMD Jayawardene ,1998-2015,448,443,218,218,0,0,218,4 (4ct 0st),0.492,1998,2015,SL
2260,R Dravid ,1996-2011,344,341,210,196,14,72,124,4 (4ct 0st),0.615,1996,2011,INDIA
2261,RS Kaluwitharana ,1990-2004,189,188,207,132,75,131,1,5 (4ct 1st),1.101,1990,2004,SL
2262,PJL Dujon ,1981-1991,169,168,204,183,21,183,0,4 (4ct 0st),1.214,1981,1991,WI
2263,JC Buttler ,2012-2019,142,138,202,171,31,171,0,6 (6ct 0st),1.463,2012,2019,ENG
2264,RD Jacobs ,1996-2004,147,145,189,160,29,160,0,6 (5ct 1st),1.3030000000000002,1996,2004,WI
2265,Kamran Akmal ,2002-2017,157,154,188,157,31,156,1,5 (4ct 1st),1.22,2002,2017,PAK
2266,D Ramdin ,2005-2016,139,137,188,181,7,181,0,5 (5ct 0st),1.372,2005,2016,WI
2267,AB de Villiers ,2005-2018,228,223,181,176,5,93,83,5 (5ct 0st),0.8109999999999999,2005,2018,SA
2268,BJ Haddin ,2001-2015,126,124,181,170,11,170,0,5 (5ct 0st),1.459,2001,2015,AUS
2269,AJ Stewart ,1989-2003,170,169,174,159,15,148,11,6 (6ct 0st),1.029,1989,2003,ENG
2270,A Flower ,1992-2003,213,212,173,141,32,133,8,5 (5ct 0st),0.816,1992,2003,ZIM
2271,Q de Kock ,2013-2019,115,111,166,158,8,158,0,6 (5ct 1st),1.495,2013,2019,SA
2272,DJ Richardson ,1991-1998,122,121,165,148,17,148,0,5 (5ct 0st),1.3630000000000002,1991,1998,SA
2273,RT Ponting ,1995-2012,375,372,160,160,0,0,160,3 (3ct 0st),0.43,1995,2012,AUS
2274,M Azharuddin ,1985-2000,334,332,156,156,0,0,156,4 (4ct 0st),0.469,1985,2000,INDIA
2275,NR Mongia ,1994-2000,140,139,154,110,44,110,0,5 (4ct 1st),1.107,1994,2000,INDIA
2276,BRM Taylor ,2004-2019,193,193,154,125,29,96,29,5 (5ct 0st),0.797,2004,2019,ZIM
2277,T Taibu ,2001-2012,150,150,147,114,33,112,2,4 (4ct 0st),0.98,2001,2012,ZIM
2278,AC Parore ,1992-2002,179,178,141,116,25,111,5,5 (3ct 2st),0.792,1992,2002,NZ
2279,Sarfaraz Ahmed ,2007-2019,116,114,140,116,24,116,0,6 (6ct 0st),1.228,2007,2019,PAK
2280,SR Tendulkar ,1989-2012,463,456,140,140,0,0,140,4 (4ct 0st),0.307,1989,2012,INDIA
2281,LRPL Taylor ,2006-2019,228,224,137,137,0,0,137,4 (4ct 0st),0.611,2006,2019,NZ
2282,Younis Khan ,2000-2015,265,260,135,135,0,5,130,4 (4ct 0st),0.519,2000,2015,PAK
2283,SP Fleming ,1994-2007,280,276,133,133,0,0,133,4 (4ct 0st),0.481,1994,2007,NZ
2284,JH Kallis ,1996-2014,328,324,131,131,0,0,131,3 (3ct 0st),0.4039999999999999,1996,2014,SA
2285,M Muralitharan ,1993-2011,350,347,130,130,0,0,130,3 (3ct 0st),0.374,1993,2011,SL
2286,AR Border ,1979-1994,273,270,127,127,0,0,127,3 (3ct 0st),0.47,1979,1994,AUS
2287,Shahid Afridi ,1996-2015,398,392,127,127,0,0,127,2 (2ct 0st),0.3229999999999999,1996,2015,PAK
2288,Khaled Mashud ,1995-2006,126,126,126,91,35,91,0,5 (3ct 2st),1.0,1995,2006,BDESH
2289,TM Dilshan ,1999-2016,330,325,124,123,1,5,118,3 (3ct 0st),0.381,1999,2016,SL
2290,CH Gayle ,1999-2019,301,294,124,124,0,0,124,3 (3ct 0st),0.421,1999,2019,WI
2291,V Kohli ,2008-2019,242,240,124,124,0,0,124,3 (3ct 0st),0.516,2008,2019,INDIA
2292,RW Marsh ,1971-1984,92,92,124,120,4,120,0,5 (5ct 0st),1.347,1971,1984,AUS
2293,ST Jayasuriya ,1989-2011,445,441,123,123,0,0,123,3 (3ct 0st),0.278,1989,2011,SL
2294,CL Hooper ,1987-2003,227,225,120,120,0,0,120,4 (4ct 0st),0.5329999999999999,1987,2003,WI
2295,BC Lara ,1990-2007,299,296,120,120,0,0,120,3 (3ct 0st),0.405,1990,2007,WI
2296,L Ronchi ,2008-2017,85,83,117,105,12,105,0,4 (4ct 0st),1.409,2008,2017,AUS
2297,MS Wade ,2012-2017,94,94,117,108,9,108,0,5 (5ct 0st),1.244,2012,2017,AUS
2298,Inzamam-ul-Haq ,1991-2007,378,373,113,113,0,0,113,3 (3ct 0st),0.302,1991,2007,PAK
2299,SR Waugh ,1986-2002,325,324,111,111,0,0,111,3 (3ct 0st),0.342,1986,2002,AUS
2300,KC Sangakkara ,2000-2015,404,397,501,402,99,383,19,5 (4ct 1st),1.261,2000,2015,SL
2301,AC Gilchrist ,1996-2008,287,286,472,417,55,417,0,6 (6ct 0st),1.65,1996,2008,AUS
2302,MS Dhoni ,2004-2019,350,345,444,321,123,321,0,6 (5ct 1st),1.286,2004,2019,INDIA
2303,MV Boucher ,1998-2011,295,291,425,403,22,402,1,6 (6ct 0st),1.46,1998,2011,SA
2304,Moin Khan ,1990-2004,219,217,287,214,73,214,0,5 (5ct 0st),1.3219999999999998,1990,2004,PAK
2305,BB McCullum ,2002-2016,260,257,277,262,15,227,35,5 (5ct 0st),1.077,2002,2016,NZ
2306,IA Healy ,1988-1997,168,168,233,194,39,194,0,4 (4ct 0st),1.386,1988,1997,AUS
2307,Mushfiqur Rahim ,2006-2019,216,215,225,181,44,179,2,5 (5ct 0st),1.046,2006,2019,BDESH
2308,Rashid Latif ,1992-2003,166,164,220,182,38,182,0,5 (5ct 0st),1.341,1992,2003,PAK
2309,DPMD Jayawardene ,1998-2015,448,443,218,218,0,0,218,4 (4ct 0st),0.492,1998,2015,SL
2310,R Dravid ,1996-2011,344,341,210,196,14,72,124,4 (4ct 0st),0.615,1996,2011,INDIA
2311,RS Kaluwitharana ,1990-2004,189,188,207,132,75,131,1,5 (4ct 1st),1.101,1990,2004,SL
2312,PJL Dujon ,1981-1991,169,168,204,183,21,183,0,4 (4ct 0st),1.214,1981,1991,WI
2313,JC Buttler ,2012-2019,142,138,202,171,31,171,0,6 (6ct 0st),1.463,2012,2019,ENG
2314,RD Jacobs ,1996-2004,147,145,189,160,29,160,0,6 (5ct 1st),1.3030000000000002,1996,2004,WI
2315,Kamran Akmal ,2002-2017,157,154,188,157,31,156,1,5 (4ct 1st),1.22,2002,2017,PAK
2316,D Ramdin ,2005-2016,139,137,188,181,7,181,0,5 (5ct 0st),1.372,2005,2016,WI
2317,AB de Villiers ,2005-2018,228,223,181,176,5,93,83,5 (5ct 0st),0.8109999999999999,2005,2018,SA
2318,BJ Haddin ,2001-2015,126,124,181,170,11,170,0,5 (5ct 0st),1.459,2001,2015,AUS
2319,AJ Stewart ,1989-2003,170,169,174,159,15,148,11,6 (6ct 0st),1.029,1989,2003,ENG
2320,A Flower ,1992-2003,213,212,173,141,32,133,8,5 (5ct 0st),0.816,1992,2003,ZIM
2321,Q de Kock ,2013-2019,115,111,166,158,8,158,0,6 (5ct 1st),1.495,2013,2019,SA
2322,DJ Richardson ,1991-1998,122,121,165,148,17,148,0,5 (5ct 0st),1.3630000000000002,1991,1998,SA
2323,RT Ponting ,1995-2012,375,372,160,160,0,0,160,3 (3ct 0st),0.43,1995,2012,AUS
2324,M Azharuddin ,1985-2000,334,332,156,156,0,0,156,4 (4ct 0st),0.469,1985,2000,INDIA
2325,NR Mongia ,1994-2000,140,139,154,110,44,110,0,5 (4ct 1st),1.107,1994,2000,INDIA
2326,BRM Taylor ,2004-2019,193,193,154,125,29,96,29,5 (5ct 0st),0.797,2004,2019,ZIM
2327,T Taibu ,2001-2012,150,150,147,114,33,112,2,4 (4ct 0st),0.98,2001,2012,ZIM
2328,AC Parore ,1992-2002,179,178,141,116,25,111,5,5 (3ct 2st),0.792,1992,2002,NZ
2329,Sarfaraz Ahmed ,2007-2019,116,114,140,116,24,116,0,6 (6ct 0st),1.228,2007,2019,PAK
2330,SR Tendulkar ,1989-2012,463,456,140,140,0,0,140,4 (4ct 0st),0.307,1989,2012,INDIA
2331,LRPL Taylor ,2006-2019,228,224,137,137,0,0,137,4 (4ct 0st),0.611,2006,2019,NZ
2332,Younis Khan ,2000-2015,265,260,135,135,0,5,130,4 (4ct 0st),0.519,2000,2015,PAK
2333,SP Fleming ,1994-2007,280,276,133,133,0,0,133,4 (4ct 0st),0.481,1994,2007,NZ
2334,JH Kallis ,1996-2014,328,324,131,131,0,0,131,3 (3ct 0st),0.4039999999999999,1996,2014,SA
2335,M Muralitharan ,1993-2011,350,347,130,130,0,0,130,3 (3ct 0st),0.374,1993,2011,SL
2336,AR Border ,1979-1994,273,270,127,127,0,0,127,3 (3ct 0st),0.47,1979,1994,AUS
2337,Shahid Afridi ,1996-2015,398,392,127,127,0,0,127,2 (2ct 0st),0.3229999999999999,1996,2015,PAK
2338,Khaled Mashud ,1995-2006,126,126,126,91,35,91,0,5 (3ct 2st),1.0,1995,2006,BDESH
2339,TM Dilshan ,1999-2016,330,325,124,123,1,5,118,3 (3ct 0st),0.381,1999,2016,SL
2340,CH Gayle ,1999-2019,301,294,124,124,0,0,124,3 (3ct 0st),0.421,1999,2019,WI
2341,V Kohli ,2008-2019,242,240,124,124,0,0,124,3 (3ct 0st),0.516,2008,2019,INDIA
2342,RW Marsh ,1971-1984,92,92,124,120,4,120,0,5 (5ct 0st),1.347,1971,1984,AUS
2343,ST Jayasuriya ,1989-2011,445,441,123,123,0,0,123,3 (3ct 0st),0.278,1989,2011,SL
2344,CL Hooper ,1987-2003,227,225,120,120,0,0,120,4 (4ct 0st),0.5329999999999999,1987,2003,WI
2345,BC Lara ,1990-2007,299,296,120,120,0,0,120,3 (3ct 0st),0.405,1990,2007,WI
2346,L Ronchi ,2008-2017,85,83,117,105,12,105,0,4 (4ct 0st),1.409,2008,2017,AUS
2347,MS Wade ,2012-2017,94,94,117,108,9,108,0,5 (5ct 0st),1.244,2012,2017,AUS
2348,Inzamam-ul-Haq ,1991-2007,378,373,113,113,0,0,113,3 (3ct 0st),0.302,1991,2007,PAK
2349,SR Waugh ,1986-2002,325,324,111,111,0,0,111,3 (3ct 0st),0.342,1986,2002,AUS
2350,KC Sangakkara ,2000-2015,404,397,501,402,99,383,19,5 (4ct 1st),1.261,2000,2015,SL
2351,AC Gilchrist ,1996-2008,287,286,472,417,55,417,0,6 (6ct 0st),1.65,1996,2008,AUS
2352,MS Dhoni ,2004-2019,350,345,444,321,123,321,0,6 (5ct 1st),1.286,2004,2019,INDIA
2353,MV Boucher ,1998-2011,295,291,425,403,22,402,1,6 (6ct 0st),1.46,1998,2011,SA
2354,Moin Khan ,1990-2004,219,217,287,214,73,214,0,5 (5ct 0st),1.3219999999999998,1990,2004,PAK
2355,BB McCullum ,2002-2016,260,257,277,262,15,227,35,5 (5ct 0st),1.077,2002,2016,NZ
2356,IA Healy ,1988-1997,168,168,233,194,39,194,0,4 (4ct 0st),1.386,1988,1997,AUS
2357,Mushfiqur Rahim ,2006-2019,216,215,225,181,44,179,2,5 (5ct 0st),1.046,2006,2019,BDESH
2358,Rashid Latif ,1992-2003,166,164,220,182,38,182,0,5 (5ct 0st),1.341,1992,2003,PAK
2359,DPMD Jayawardene ,1998-2015,448,443,218,218,0,0,218,4 (4ct 0st),0.492,1998,2015,SL
2360,R Dravid ,1996-2011,344,341,210,196,14,72,124,4 (4ct 0st),0.615,1996,2011,INDIA
2361,RS Kaluwitharana ,1990-2004,189,188,207,132,75,131,1,5 (4ct 1st),1.101,1990,2004,SL
2362,PJL Dujon ,1981-1991,169,168,204,183,21,183,0,4 (4ct 0st),1.214,1981,1991,WI
2363,JC Buttler ,2012-2019,142,138,202,171,31,171,0,6 (6ct 0st),1.463,2012,2019,ENG
2364,RD Jacobs ,1996-2004,147,145,189,160,29,160,0,6 (5ct 1st),1.3030000000000002,1996,2004,WI
2365,Kamran Akmal ,2002-2017,157,154,188,157,31,156,1,5 (4ct 1st),1.22,2002,2017,PAK
2366,D Ramdin ,2005-2016,139,137,188,181,7,181,0,5 (5ct 0st),1.372,2005,2016,WI
2367,AB de Villiers ,2005-2018,228,223,181,176,5,93,83,5 (5ct 0st),0.8109999999999999,2005,2018,SA
2368,BJ Haddin ,2001-2015,126,124,181,170,11,170,0,5 (5ct 0st),1.459,2001,2015,AUS
2369,AJ Stewart ,1989-2003,170,169,174,159,15,148,11,6 (6ct 0st),1.029,1989,2003,ENG
2370,A Flower ,1992-2003,213,212,173,141,32,133,8,5 (5ct 0st),0.816,1992,2003,ZIM
2371,Q de Kock ,2013-2019,115,111,166,158,8,158,0,6 (5ct 1st),1.495,2013,2019,SA
2372,DJ Richardson ,1991-1998,122,121,165,148,17,148,0,5 (5ct 0st),1.3630000000000002,1991,1998,SA
2373,RT Ponting ,1995-2012,375,372,160,160,0,0,160,3 (3ct 0st),0.43,1995,2012,AUS
2374,M Azharuddin ,1985-2000,334,332,156,156,0,0,156,4 (4ct 0st),0.469,1985,2000,INDIA
2375,NR Mongia ,1994-2000,140,139,154,110,44,110,0,5 (4ct 1st),1.107,1994,2000,INDIA
2376,BRM Taylor ,2004-2019,193,193,154,125,29,96,29,5 (5ct 0st),0.797,2004,2019,ZIM
2377,T Taibu ,2001-2012,150,150,147,114,33,112,2,4 (4ct 0st),0.98,2001,2012,ZIM
2378,AC Parore ,1992-2002,179,178,141,116,25,111,5,5 (3ct 2st),0.792,1992,2002,NZ
2379,Sarfaraz Ahmed ,2007-2019,116,114,140,116,24,116,0,6 (6ct 0st),1.228,2007,2019,PAK
2380,SR Tendulkar ,1989-2012,463,456,140,140,0,0,140,4 (4ct 0st),0.307,1989,2012,INDIA
2381,LRPL Taylor ,2006-2019,228,224,137,137,0,0,137,4 (4ct 0st),0.611,2006,2019,NZ
2382,Younis Khan ,2000-2015,265,260,135,135,0,5,130,4 (4ct 0st),0.519,2000,2015,PAK
2383,SP Fleming ,1994-2007,280,276,133,133,0,0,133,4 (4ct 0st),0.481,1994,2007,NZ
2384,JH Kallis ,1996-2014,328,324,131,131,0,0,131,3 (3ct 0st),0.4039999999999999,1996,2014,SA
2385,M Muralitharan ,1993-2011,350,347,130,130,0,0,130,3 (3ct 0st),0.374,1993,2011,SL
2386,AR Border ,1979-1994,273,270,127,127,0,0,127,3 (3ct 0st),0.47,1979,1994,AUS
2387,Shahid Afridi ,1996-2015,398,392,127,127,0,0,127,2 (2ct 0st),0.3229999999999999,1996,2015,PAK
2388,Khaled Mashud ,1995-2006,126,126,126,91,35,91,0,5 (3ct 2st),1.0,1995,2006,BDESH
2389,TM Dilshan ,1999-2016,330,325,124,123,1,5,118,3 (3ct 0st),0.381,1999,2016,SL
2390,CH Gayle ,1999-2019,301,294,124,124,0,0,124,3 (3ct 0st),0.421,1999,2019,WI
2391,V Kohli ,2008-2019,242,240,124,124,0,0,124,3 (3ct 0st),0.516,2008,2019,INDIA
2392,RW Marsh ,1971-1984,92,92,124,120,4,120,0,5 (5ct 0st),1.347,1971,1984,AUS
2393,ST Jayasuriya ,1989-2011,445,441,123,123,0,0,123,3 (3ct 0st),0.278,1989,2011,SL
2394,CL Hooper ,1987-2003,227,225,120,120,0,0,120,4 (4ct 0st),0.5329999999999999,1987,2003,WI
2395,BC Lara ,1990-2007,299,296,120,120,0,0,120,3 (3ct 0st),0.405,1990,2007,WI
2396,L Ronchi ,2008-2017,85,83,117,105,12,105,0,4 (4ct 0st),1.409,2008,2017,AUS
2397,MS Wade ,2012-2017,94,94,117,108,9,108,0,5 (5ct 0st),1.244,2012,2017,AUS
2398,Inzamam-ul-Haq ,1991-2007,378,373,113,113,0,0,113,3 (3ct 0st),0.302,1991,2007,PAK
2399,SR Waugh ,1986-2002,325,324,111,111,0,0,111,3 (3ct 0st),0.342,1986,2002,AUS
2400,KC Sangakkara ,2000-2015,404,397,501,402,99,383,19,5 (4ct 1st),1.261,2000,2015,SL
2401,AC Gilchrist ,1996-2008,287,286,472,417,55,417,0,6 (6ct 0st),1.65,1996,2008,AUS
2402,MS Dhoni ,2004-2019,350,345,444,321,123,321,0,6 (5ct 1st),1.286,2004,2019,INDIA
2403,MV Boucher ,1998-2011,295,291,425,403,22,402,1,6 (6ct 0st),1.46,1998,2011,SA
2404,Moin Khan ,1990-2004,219,217,287,214,73,214,0,5 (5ct 0st),1.3219999999999998,1990,2004,PAK
2405,BB McCullum ,2002-2016,260,257,277,262,15,227,35,5 (5ct 0st),1.077,2002,2016,NZ
2406,IA Healy ,1988-1997,168,168,233,194,39,194,0,4 (4ct 0st),1.386,1988,1997,AUS
2407,Mushfiqur Rahim ,2006-2019,216,215,225,181,44,179,2,5 (5ct 0st),1.046,2006,2019,BDESH
2408,Rashid Latif ,1992-2003,166,164,220,182,38,182,0,5 (5ct 0st),1.341,1992,2003,PAK
2409,DPMD Jayawardene ,1998-2015,448,443,218,218,0,0,218,4 (4ct 0st),0.492,1998,2015,SL
2410,R Dravid ,1996-2011,344,341,210,196,14,72,124,4 (4ct 0st),0.615,1996,2011,INDIA
2411,RS Kaluwitharana ,1990-2004,189,188,207,132,75,131,1,5 (4ct 1st),1.101,1990,2004,SL
2412,PJL Dujon ,1981-1991,169,168,204,183,21,183,0,4 (4ct 0st),1.214,1981,1991,WI
2413,JC Buttler ,2012-2019,142,138,202,171,31,171,0,6 (6ct 0st),1.463,2012,2019,ENG
2414,RD Jacobs ,1996-2004,147,145,189,160,29,160,0,6 (5ct 1st),1.3030000000000002,1996,2004,WI
2415,Kamran Akmal ,2002-2017,157,154,188,157,31,156,1,5 (4ct 1st),1.22,2002,2017,PAK
2416,D Ramdin ,2005-2016,139,137,188,181,7,181,0,5 (5ct 0st),1.372,2005,2016,WI
2417,AB de Villiers ,2005-2018,228,223,181,176,5,93,83,5 (5ct 0st),0.8109999999999999,2005,2018,SA
2418,BJ Haddin ,2001-2015,126,124,181,170,11,170,0,5 (5ct 0st),1.459,2001,2015,AUS
2419,AJ Stewart ,1989-2003,170,169,174,159,15,148,11,6 (6ct 0st),1.029,1989,2003,ENG
2420,A Flower ,1992-2003,213,212,173,141,32,133,8,5 (5ct 0st),0.816,1992,2003,ZIM
2421,Q de Kock ,2013-2019,115,111,166,158,8,158,0,6 (5ct 1st),1.495,2013,2019,SA
2422,DJ Richardson ,1991-1998,122,121,165,148,17,148,0,5 (5ct 0st),1.3630000000000002,1991,1998,SA
2423,RT Ponting ,1995-2012,375,372,160,160,0,0,160,3 (3ct 0st),0.43,1995,2012,AUS
2424,M Azharuddin ,1985-2000,334,332,156,156,0,0,156,4 (4ct 0st),0.469,1985,2000,INDIA
2425,NR Mongia ,1994-2000,140,139,154,110,44,110,0,5 (4ct 1st),1.107,1994,2000,INDIA
2426,BRM Taylor ,2004-2019,193,193,154,125,29,96,29,5 (5ct 0st),0.797,2004,2019,ZIM
2427,T Taibu ,2001-2012,150,150,147,114,33,112,2,4 (4ct 0st),0.98,2001,2012,ZIM
2428,AC Parore ,1992-2002,179,178,141,116,25,111,5,5 (3ct 2st),0.792,1992,2002,NZ
2429,Sarfaraz Ahmed ,2007-2019,116,114,140,116,24,116,0,6 (6ct 0st),1.228,2007,2019,PAK
2430,SR Tendulkar ,1989-2012,463,456,140,140,0,0,140,4 (4ct 0st),0.307,1989,2012,INDIA
2431,LRPL Taylor ,2006-2019,228,224,137,137,0,0,137,4 (4ct 0st),0.611,2006,2019,NZ
2432,Younis Khan ,2000-2015,265,260,135,135,0,5,130,4 (4ct 0st),0.519,2000,2015,PAK
2433,SP Fleming ,1994-2007,280,276,133,133,0,0,133,4 (4ct 0st),0.481,1994,2007,NZ
2434,JH Kallis ,1996-2014,328,324,131,131,0,0,131,3 (3ct 0st),0.4039999999999999,1996,2014,SA
2435,M Muralitharan ,1993-2011,350,347,130,130,0,0,130,3 (3ct 0st),0.374,1993,2011,SL
2436,AR Border ,1979-1994,273,270,127,127,0,0,127,3 (3ct 0st),0.47,1979,1994,AUS
2437,Shahid Afridi ,1996-2015,398,392,127,127,0,0,127,2 (2ct 0st),0.3229999999999999,1996,2015,PAK
2438,Khaled Mashud ,1995-2006,126,126,126,91,35,91,0,5 (3ct 2st),1.0,1995,2006,BDESH
2439,TM Dilshan ,1999-2016,330,325,124,123,1,5,118,3 (3ct 0st),0.381,1999,2016,SL
2440,CH Gayle ,1999-2019,301,294,124,124,0,0,124,3 (3ct 0st),0.421,1999,2019,WI
2441,V Kohli ,2008-2019,242,240,124,124,0,0,124,3 (3ct 0st),0.516,2008,2019,INDIA
2442,RW Marsh ,1971-1984,92,92,124,120,4,120,0,5 (5ct 0st),1.347,1971,1984,AUS
2443,ST Jayasuriya ,1989-2011,445,441,123,123,0,0,123,3 (3ct 0st),0.278,1989,2011,SL
2444,CL Hooper ,1987-2003,227,225,120,120,0,0,120,4 (4ct 0st),0.5329999999999999,1987,2003,WI
2445,BC Lara ,1990-2007,299,296,120,120,0,0,120,3 (3ct 0st),0.405,1990,2007,WI
2446,L Ronchi ,2008-2017,85,83,117,105,12,105,0,4 (4ct 0st),1.409,2008,2017,AUS
2447,MS Wade ,2012-2017,94,94,117,108,9,108,0,5 (5ct 0st),1.244,2012,2017,AUS
2448,Inzamam-ul-Haq ,1991-2007,378,373,113,113,0,0,113,3 (3ct 0st),0.302,1991,2007,PAK
2449,SR Waugh ,1986-2002,325,324,111,111,0,0,111,3 (3ct 0st),0.342,1986,2002,AUS
2450,KC Sangakkara ,2000-2015,404,397,501,402,99,383,19,5 (4ct 1st),1.261,2000,2015,SL
2451,AC Gilchrist ,1996-2008,287,286,472,417,55,417,0,6 (6ct 0st),1.65,1996,2008,AUS
2452,MS Dhoni ,2004-2019,350,345,444,321,123,321,0,6 (5ct 1st),1.286,2004,2019,INDIA
2453,MV Boucher ,1998-2011,295,291,425,403,22,402,1,6 (6ct 0st),1.46,1998,2011,SA
2454,Moin Khan ,1990-2004,219,217,287,214,73,214,0,5 (5ct 0st),1.3219999999999998,1990,2004,PAK
2455,BB McCullum ,2002-2016,260,257,277,262,15,227,35,5 (5ct 0st),1.077,2002,2016,NZ
2456,IA Healy ,1988-1997,168,168,233,194,39,194,0,4 (4ct 0st),1.386,1988,1997,AUS
2457,Mushfiqur Rahim ,2006-2019,216,215,225,181,44,179,2,5 (5ct 0st),1.046,2006,2019,BDESH
2458,Rashid Latif ,1992-2003,166,164,220,182,38,182,0,5 (5ct 0st),1.341,1992,2003,PAK
2459,DPMD Jayawardene ,1998-2015,448,443,218,218,0,0,218,4 (4ct 0st),0.492,1998,2015,SL
2460,R Dravid ,1996-2011,344,341,210,196,14,72,124,4 (4ct 0st),0.615,1996,2011,INDIA
2461,RS Kaluwitharana ,1990-2004,189,188,207,132,75,131,1,5 (4ct 1st),1.101,1990,2004,SL
2462,PJL Dujon ,1981-1991,169,168,204,183,21,183,0,4 (4ct 0st),1.214,1981,1991,WI
2463,JC Buttler ,2012-2019,142,138,202,171,31,171,0,6 (6ct 0st),1.463,2012,2019,ENG
2464,RD Jacobs ,1996-2004,147,145,189,160,29,160,0,6 (5ct 1st),1.3030000000000002,1996,2004,WI
2465,Kamran Akmal ,2002-2017,157,154,188,157,31,156,1,5 (4ct 1st),1.22,2002,2017,PAK
2466,D Ramdin ,2005-2016,139,137,188,181,7,181,0,5 (5ct 0st),1.372,2005,2016,WI
2467,AB de Villiers ,2005-2018,228,223,181,176,5,93,83,5 (5ct 0st),0.8109999999999999,2005,2018,SA
2468,BJ Haddin ,2001-2015,126,124,181,170,11,170,0,5 (5ct 0st),1.459,2001,2015,AUS
2469,AJ Stewart ,1989-2003,170,169,174,159,15,148,11,6 (6ct 0st),1.029,1989,2003,ENG
2470,A Flower ,1992-2003,213,212,173,141,32,133,8,5 (5ct 0st),0.816,1992,2003,ZIM
2471,Q de Kock ,2013-2019,115,111,166,158,8,158,0,6 (5ct 1st),1.495,2013,2019,SA
2472,DJ Richardson ,1991-1998,122,121,165,148,17,148,0,5 (5ct 0st),1.3630000000000002,1991,1998,SA
2473,RT Ponting ,1995-2012,375,372,160,160,0,0,160,3 (3ct 0st),0.43,1995,2012,AUS
2474,M Azharuddin ,1985-2000,334,332,156,156,0,0,156,4 (4ct 0st),0.469,1985,2000,INDIA
2475,NR Mongia ,1994-2000,140,139,154,110,44,110,0,5 (4ct 1st),1.107,1994,2000,INDIA
2476,BRM Taylor ,2004-2019,193,193,154,125,29,96,29,5 (5ct 0st),0.797,2004,2019,ZIM
2477,T Taibu ,2001-2012,150,150,147,114,33,112,2,4 (4ct 0st),0.98,2001,2012,ZIM
2478,AC Parore ,1992-2002,179,178,141,116,25,111,5,5 (3ct 2st),0.792,1992,2002,NZ
2479,Sarfaraz Ahmed ,2007-2019,116,114,140,116,24,116,0,6 (6ct 0st),1.228,2007,2019,PAK
2480,SR Tendulkar ,1989-2012,463,456,140,140,0,0,140,4 (4ct 0st),0.307,1989,2012,INDIA
2481,LRPL Taylor ,2006-2019,228,224,137,137,0,0,137,4 (4ct 0st),0.611,2006,2019,NZ
2482,Younis Khan ,2000-2015,265,260,135,135,0,5,130,4 (4ct 0st),0.519,2000,2015,PAK
2483,SP Fleming ,1994-2007,280,276,133,133,0,0,133,4 (4ct 0st),0.481,1994,2007,NZ
2484,JH Kallis ,1996-2014,328,324,131,131,0,0,131,3 (3ct 0st),0.4039999999999999,1996,2014,SA
2485,M Muralitharan ,1993-2011,350,347,130,130,0,0,130,3 (3ct 0st),0.374,1993,2011,SL
2486,AR Border ,1979-1994,273,270,127,127,0,0,127,3 (3ct 0st),0.47,1979,1994,AUS
2487,Shahid Afridi ,1996-2015,398,392,127,127,0,0,127,2 (2ct 0st),0.3229999999999999,1996,2015,PAK
2488,Khaled Mashud ,1995-2006,126,126,126,91,35,91,0,5 (3ct 2st),1.0,1995,2006,BDESH
2489,TM Dilshan ,1999-2016,330,325,124,123,1,5,118,3 (3ct 0st),0.381,1999,2016,SL
2490,CH Gayle ,1999-2019,301,294,124,124,0,0,124,3 (3ct 0st),0.421,1999,2019,WI
2491,V Kohli ,2008-2019,242,240,124,124,0,0,124,3 (3ct 0st),0.516,2008,2019,INDIA
2492,RW Marsh ,1971-1984,92,92,124,120,4,120,0,5 (5ct 0st),1.347,1971,1984,AUS
2493,ST Jayasuriya ,1989-2011,445,441,123,123,0,0,123,3 (3ct 0st),0.278,1989,2011,SL
2494,CL Hooper ,1987-2003,227,225,120,120,0,0,120,4 (4ct 0st),0.5329999999999999,1987,2003,WI
2495,BC Lara ,1990-2007,299,296,120,120,0,0,120,3 (3ct 0st),0.405,1990,2007,WI
2496,L Ronchi ,2008-2017,85,83,117,105,12,105,0,4 (4ct 0st),1.409,2008,2017,AUS
2497,MS Wade ,2012-2017,94,94,117,108,9,108,0,5 (5ct 0st),1.244,2012,2017,AUS
2498,Inzamam-ul-Haq ,1991-2007,378,373,113,113,0,0,113,3 (3ct 0st),0.302,1991,2007,PAK
2499,SR Waugh ,1986-2002,325,324,111,111,0,0,111,3 (3ct 0st),0.342,1986,2002,AUS
2500,KC Sangakkara ,2000-2015,404,397,501,402,99,383,19,5 (4ct 1st),1.261,2000,2015,SL
2501,AC Gilchrist ,1996-2008,287,286,472,417,55,417,0,6 (6ct 0st),1.65,1996,2008,AUS
2502,MS Dhoni ,2004-2019,350,345,444,321,123,321,0,6 (5ct 1st),1.286,2004,2019,INDIA
2503,MV Boucher ,1998-2011,295,291,425,403,22,402,1,6 (6ct 0st),1.46,1998,2011,SA
2504,Moin Khan ,1990-2004,219,217,287,214,73,214,0,5 (5ct 0st),1.3219999999999998,1990,2004,PAK
2505,BB McCullum ,2002-2016,260,257,277,262,15,227,35,5 (5ct 0st),1.077,2002,2016,NZ
2506,IA Healy ,1988-1997,168,168,233,194,39,194,0,4 (4ct 0st),1.386,1988,1997,AUS
2507,Mushfiqur Rahim ,2006-2019,216,215,225,181,44,179,2,5 (5ct 0st),1.046,2006,2019,BDESH
2508,Rashid Latif ,1992-2003,166,164,220,182,38,182,0,5 (5ct 0st),1.341,1992,2003,PAK
2509,DPMD Jayawardene ,1998-2015,448,443,218,218,0,0,218,4 (4ct 0st),0.492,1998,2015,SL
2510,R Dravid ,1996-2011,344,341,210,196,14,72,124,4 (4ct 0st),0.615,1996,2011,INDIA
2511,RS Kaluwitharana ,1990-2004,189,188,207,132,75,131,1,5 (4ct 1st),1.101,1990,2004,SL
2512,PJL Dujon ,1981-1991,169,168,204,183,21,183,0,4 (4ct 0st),1.214,1981,1991,WI
2513,JC Buttler ,2012-2019,142,138,202,171,31,171,0,6 (6ct 0st),1.463,2012,2019,ENG
2514,RD Jacobs ,1996-2004,147,145,189,160,29,160,0,6 (5ct 1st),1.3030000000000002,1996,2004,WI
2515,Kamran Akmal ,2002-2017,157,154,188,157,31,156,1,5 (4ct 1st),1.22,2002,2017,PAK
2516,D Ramdin ,2005-2016,139,137,188,181,7,181,0,5 (5ct 0st),1.372,2005,2016,WI
2517,AB de Villiers ,2005-2018,228,223,181,176,5,93,83,5 (5ct 0st),0.8109999999999999,2005,2018,SA
2518,BJ Haddin ,2001-2015,126,124,181,170,11,170,0,5 (5ct 0st),1.459,2001,2015,AUS
2519,AJ Stewart ,1989-2003,170,169,174,159,15,148,11,6 (6ct 0st),1.029,1989,2003,ENG
2520,A Flower ,1992-2003,213,212,173,141,32,133,8,5 (5ct 0st),0.816,1992,2003,ZIM
2521,Q de Kock ,2013-2019,115,111,166,158,8,158,0,6 (5ct 1st),1.495,2013,2019,SA
2522,DJ Richardson ,1991-1998,122,121,165,148,17,148,0,5 (5ct 0st),1.3630000000000002,1991,1998,SA
2523,RT Ponting ,1995-2012,375,372,160,160,0,0,160,3 (3ct 0st),0.43,1995,2012,AUS
2524,M Azharuddin ,1985-2000,334,332,156,156,0,0,156,4 (4ct 0st),0.469,1985,2000,INDIA
2525,NR Mongia ,1994-2000,140,139,154,110,44,110,0,5 (4ct 1st),1.107,1994,2000,INDIA
2526,BRM Taylor ,2004-2019,193,193,154,125,29,96,29,5 (5ct 0st),0.797,2004,2019,ZIM
2527,T Taibu ,2001-2012,150,150,147,114,33,112,2,4 (4ct 0st),0.98,2001,2012,ZIM
2528,AC Parore ,1992-2002,179,178,141,116,25,111,5,5 (3ct 2st),0.792,1992,2002,NZ
2529,Sarfaraz Ahmed ,2007-2019,116,114,140,116,24,116,0,6 (6ct 0st),1.228,2007,2019,PAK
2530,SR Tendulkar ,1989-2012,463,456,140,140,0,0,140,4 (4ct 0st),0.307,1989,2012,INDIA
2531,LRPL Taylor ,2006-2019,228,224,137,137,0,0,137,4 (4ct 0st),0.611,2006,2019,NZ
2532,Younis Khan ,2000-2015,265,260,135,135,0,5,130,4 (4ct 0st),0.519,2000,2015,PAK
2533,SP Fleming ,1994-2007,280,276,133,133,0,0,133,4 (4ct 0st),0.481,1994,2007,NZ
2534,JH Kallis ,1996-2014,328,324,131,131,0,0,131,3 (3ct 0st),0.4039999999999999,1996,2014,SA
2535,M Muralitharan ,1993-2011,350,347,130,130,0,0,130,3 (3ct 0st),0.374,1993,2011,SL
2536,AR Border ,1979-1994,273,270,127,127,0,0,127,3 (3ct 0st),0.47,1979,1994,AUS
2537,Shahid Afridi ,1996-2015,398,392,127,127,0,0,127,2 (2ct 0st),0.3229999999999999,1996,2015,PAK
2538,Khaled Mashud ,1995-2006,126,126,126,91,35,91,0,5 (3ct 2st),1.0,1995,2006,BDESH
2539,TM Dilshan ,1999-2016,330,325,124,123,1,5,118,3 (3ct 0st),0.381,1999,2016,SL
2540,CH Gayle ,1999-2019,301,294,124,124,0,0,124,3 (3ct 0st),0.421,1999,2019,WI
2541,V Kohli ,2008-2019,242,240,124,124,0,0,124,3 (3ct 0st),0.516,2008,2019,INDIA
2542,RW Marsh ,1971-1984,92,92,124,120,4,120,0,5 (5ct 0st),1.347,1971,1984,AUS
2543,ST Jayasuriya ,1989-2011,445,441,123,123,0,0,123,3 (3ct 0st),0.278,1989,2011,SL
2544,CL Hooper ,1987-2003,227,225,120,120,0,0,120,4 (4ct 0st),0.5329999999999999,1987,2003,WI
2545,BC Lara ,1990-2007,299,296,120,120,0,0,120,3 (3ct 0st),0.405,1990,2007,WI
2546,L Ronchi ,2008-2017,85,83,117,105,12,105,0,4 (4ct 0st),1.409,2008,2017,AUS
2547,MS Wade ,2012-2017,94,94,117,108,9,108,0,5 (5ct 0st),1.244,2012,2017,AUS
2548,Inzamam-ul-Haq ,1991-2007,378,373,113,113,0,0,113,3 (3ct 0st),0.302,1991,2007,PAK
2549,SR Waugh ,1986-2002,325,324,111,111,0,0,111,3 (3ct 0st),0.342,1986,2002,AUS
2550,KC Sangakkara ,2000-2015,404,397,501,402,99,383,19,5 (4ct 1st),1.261,2000,2015,SL
2551,AC Gilchrist ,1996-2008,287,286,472,417,55,417,0,6 (6ct 0st),1.65,1996,2008,AUS
2552,MS Dhoni ,2004-2019,350,345,444,321,123,321,0,6 (5ct 1st),1.286,2004,2019,INDIA
2553,MV Boucher ,1998-2011,295,291,425,403,22,402,1,6 (6ct 0st),1.46,1998,2011,SA
2554,Moin Khan ,1990-2004,219,217,287,214,73,214,0,5 (5ct 0st),1.3219999999999998,1990,2004,PAK
2555,BB McCullum ,2002-2016,260,257,277,262,15,227,35,5 (5ct 0st),1.077,2002,2016,NZ
2556,IA Healy ,1988-1997,168,168,233,194,39,194,0,4 (4ct 0st),1.386,1988,1997,AUS
2557,Mushfiqur Rahim ,2006-2019,216,215,225,181,44,179,2,5 (5ct 0st),1.046,2006,2019,BDESH
2558,Rashid Latif ,1992-2003,166,164,220,182,38,182,0,5 (5ct 0st),1.341,1992,2003,PAK
2559,DPMD Jayawardene ,1998-2015,448,443,218,218,0,0,218,4 (4ct 0st),0.492,1998,2015,SL
2560,R Dravid ,1996-2011,344,341,210,196,14,72,124,4 (4ct 0st),0.615,1996,2011,INDIA
2561,RS Kaluwitharana ,1990-2004,189,188,207,132,75,131,1,5 (4ct 1st),1.101,1990,2004,SL
2562,PJL Dujon ,1981-1991,169,168,204,183,21,183,0,4 (4ct 0st),1.214,1981,1991,WI
2563,JC Buttler ,2012-2019,142,138,202,171,31,171,0,6 (6ct 0st),1.463,2012,2019,ENG
2564,RD Jacobs ,1996-2004,147,145,189,160,29,160,0,6 (5ct 1st),1.3030000000000002,1996,2004,WI
2565,Kamran Akmal ,2002-2017,157,154,188,157,31,156,1,5 (4ct 1st),1.22,2002,2017,PAK
2566,D Ramdin ,2005-2016,139,137,188,181,7,181,0,5 (5ct 0st),1.372,2005,2016,WI
2567,AB de Villiers ,2005-2018,228,223,181,176,5,93,83,5 (5ct 0st),0.8109999999999999,2005,2018,SA
2568,BJ Haddin ,2001-2015,126,124,181,170,11,170,0,5 (5ct 0st),1.459,2001,2015,AUS
2569,AJ Stewart ,1989-2003,170,169,174,159,15,148,11,6 (6ct 0st),1.029,1989,2003,ENG
2570,A Flower ,1992-2003,213,212,173,141,32,133,8,5 (5ct 0st),0.816,1992,2003,ZIM
2571,Q de Kock ,2013-2019,115,111,166,158,8,158,0,6 (5ct 1st),1.495,2013,2019,SA
2572,DJ Richardson ,1991-1998,122,121,165,148,17,148,0,5 (5ct 0st),1.3630000000000002,1991,1998,SA
2573,RT Ponting ,1995-2012,375,372,160,160,0,0,160,3 (3ct 0st),0.43,1995,2012,AUS
2574,M Azharuddin ,1985-2000,334,332,156,156,0,0,156,4 (4ct 0st),0.469,1985,2000,INDIA
2575,NR Mongia ,1994-2000,140,139,154,110,44,110,0,5 (4ct 1st),1.107,1994,2000,INDIA
2576,BRM Taylor ,2004-2019,193,193,154,125,29,96,29,5 (5ct 0st),0.797,2004,2019,ZIM
2577,T Taibu ,2001-2012,150,150,147,114,33,112,2,4 (4ct 0st),0.98,2001,2012,ZIM
2578,AC Parore ,1992-2002,179,178,141,116,25,111,5,5 (3ct 2st),0.792,1992,2002,NZ
2579,Sarfaraz Ahmed ,2007-2019,116,114,140,116,24,116,0,6 (6ct 0st),1.228,2007,2019,PAK
2580,SR Tendulkar ,1989-2012,463,456,140,140,0,0,140,4 (4ct 0st),0.307,1989,2012,INDIA
2581,LRPL Taylor ,2006-2019,228,224,137,137,0,0,137,4 (4ct 0st),0.611,2006,2019,NZ
2582,Younis Khan ,2000-2015,265,260,135,135,0,5,130,4 (4ct 0st),0.519,2000,2015,PAK
2583,SP Fleming ,1994-2007,280,276,133,133,0,0,133,4 (4ct 0st),0.481,1994,2007,NZ
2584,JH Kallis ,1996-2014,328,324,131,131,0,0,131,3 (3ct 0st),0.4039999999999999,1996,2014,SA
2585,M Muralitharan ,1993-2011,350,347,130,130,0,0,130,3 (3ct 0st),0.374,1993,2011,SL
2586,AR Border ,1979-1994,273,270,127,127,0,0,127,3 (3ct 0st),0.47,1979,1994,AUS
2587,Shahid Afridi ,1996-2015,398,392,127,127,0,0,127,2 (2ct 0st),0.3229999999999999,1996,2015,PAK
2588,Khaled Mashud ,1995-2006,126,126,126,91,35,91,0,5 (3ct 2st),1.0,1995,2006,BDESH
2589,TM Dilshan ,1999-2016,330,325,124,123,1,5,118,3 (3ct 0st),0.381,1999,2016,SL
2590,CH Gayle ,1999-2019,301,294,124,124,0,0,124,3 (3ct 0st),0.421,1999,2019,WI
2591,V Kohli ,2008-2019,242,240,124,124,0,0,124,3 (3ct 0st),0.516,2008,2019,INDIA
2592,RW Marsh ,1971-1984,92,92,124,120,4,120,0,5 (5ct 0st),1.347,1971,1984,AUS
2593,ST Jayasuriya ,1989-2011,445,441,123,123,0,0,123,3 (3ct 0st),0.278,1989,2011,SL
2594,CL Hooper ,1987-2003,227,225,120,120,0,0,120,4 (4ct 0st),0.5329999999999999,1987,2003,WI
2595,BC Lara ,1990-2007,299,296,120,120,0,0,120,3 (3ct 0st),0.405,1990,2007,WI
2596,L Ronchi ,2008-2017,85,83,117,105,12,105,0,4 (4ct 0st),1.409,2008,2017,AUS
2597,MS Wade ,2012-2017,94,94,117,108,9,108,0,5 (5ct 0st),1.244,2012,2017,AUS
2598,Inzamam-ul-Haq ,1991-2007,378,373,113,113,0,0,113,3 (3ct 0st),0.302,1991,2007,PAK
2599,SR Waugh ,1986-2002,325,324,111,111,0,0,111,3 (3ct 0st),0.342,1986,2002,AUS
