,Player,Span,Mat,Inns,Dis,Ct,St,Ct Wk,Ct Fi,MD,D/I,Final Region,Start,End
0,MV Boucher,1997-2012,147,281,555,532,23,532,0,6 (6ct 0st),1.975,SA,1997,2012
1,AC Gilchrist,1999-2008,96,191,416,379,37,379,0,5 (5ct 0st),2.178,AUS,1999,2008
2,IA Healy,1988-1999,119,224,395,366,29,366,0,6 (6ct 0st),1.763,AUS,1988,1999
3,RW Marsh,1970-1984,96,182,355,343,12,343,0,6 (6ct 0st),1.95,AUS,1970,1984
4,MS Dhoni,2005-2014,90,166,294,256,38,256,0,6 (6ct 0st),1.771,INDIA,2005,2014
5,AJ Stewart,1990-2003,133,231,277,263,14,227,36,6 (6ct 0st),1.199,ENG,1990,2003
6,PJL Dujon,1981-1991,81,154,272,267,5,265,2,5 (5ct 0st),1.766,WI,1981,1991
7,BJ Haddin,2008-2015,66,128,270,262,8,262,0,6 (6ct 0st),2.109,AUS,2008,2015
8,APE Knott,1967-1981,95,174,269,250,19,250,0,5 (4ct 1st),1.545,ENG,1967,1981
9,MJ Prior,2007-2014,79,146,256,243,13,243,0,6 (6ct 0st),1.753,ENG,2007,2014
10,BJ Watling,2009-2019,67,127,236,228,8,218,10,6 (6ct 0st),1.858,NZ,2009,2019
11,Wasim Bari,1967-1984,81,146,228,201,27,201,0,7 (7ct 0st),1.561,PAK,1967,1984
12,AB de Villiers,2004-2018,114,217,227,222,5,101,121,6 (6ct 0st),1.046,SA,2004,2018
13,TG Evans,1946-1959,91,175,219,173,46,173,0,4 (4ct 0st),1.251,ENG,1946,1959
14,RD Jacobs,1998-2004,65,122,219,207,12,207,0,7 (7ct 0st),1.795,WI,1998,2004
15,D Ramdin,2005-2016,74,131,217,205,12,205,0,5 (5ct 0st),1.656,WI,2005,2016
16,R Dravid,1996-2012,164,301,210,210,0,0,210,3 (3ct 0st),0.6970000000000001,INDIA,1996,2012
17,BB McCullum,2004-2016,101,186,209,198,11,168,30,5 (5ct 0st),1.123,NZ,2004,2016
18,Kamran Akmal,2002-2010,53,99,206,184,22,184,0,5 (5ct 0st),2.08,PAK,2002,2010
19,DPMD Jayawardene,1997-2014,149,270,205,205,0,0,205,4 (4ct 0st),0.759,SL,1997,2014
20,AC Parore,1990-2002,78,138,204,197,7,194,3,5 (5ct 0st),1.4780000000000002,NZ,1990,2002
21,KC Sangakkara,2000-2015,134,248,202,182,20,131,51,5 (5ct 0st),0.8140000000000001,SL,2000,2015
22,JH Kallis,1995-2013,166,315,200,200,0,0,200,4 (4ct 0st),0.634,SA,1995,2013
23,SMH Kirmani,1976-1986,88,151,198,160,38,160,0,6 (5ct 1st),1.311,INDIA,1976,1986
24,JM Bairstow,2012-2019,70,132,197,184,13,173,11,6 (6ct 0st),1.492,ENG,2012,2019
25,RT Ponting,1995-2012,168,328,196,196,0,0,196,3 (3ct 0st),0.597,AUS,1995,2012
26,DL Murray,1963-1980,62,119,189,181,8,181,0,5 (5ct 0st),1.588,WI,1963,1980
27,Q de Kock,2014-2019,44,82,187,176,11,176,0,6 (6ct 0st),2.28,SA,2014,2019
28,ATW Grout,1957-1966,51,98,187,163,24,163,0,6 (6ct 0st),1.908,AUS,1957,1966
29,ME Waugh,1991-2002,128,245,181,181,0,0,181,4 (4ct 0st),0.738,AUS,1991,2002
30,IDS Smith,1980-1992,63,109,176,168,8,168,0,7 (7ct 0st),1.614,NZ,1980,1992
31,AN Cook,2006-2018,161,300,175,175,0,0,175,3 (3ct 0st),0.583,ENG,2006,2018
32,RW Taylor,1971-1984,57,106,174,167,7,167,0,7 (7ct 0st),1.641,ENG,1971,1984
33,SP Fleming,1994-2008,111,199,171,171,0,0,171,5 (5ct 0st),0.8590000000000001,NZ,1994,2008
34,GC Smith,2002-2014,117,225,169,169,0,0,169,5 (5ct 0st),0.7509999999999999,SA,2002,2014
35,Sarfaraz Ahmed,2010-2019,49,94,167,146,21,146,0,5 (5ct 0st),1.776,PAK,2010,2019
36,RC Russell,1988-1998,54,96,165,153,12,153,0,6 (6ct 0st),1.7180000000000002,ENG,1988,1998
37,BC Lara,1990-2006,131,241,164,164,0,0,164,4 (4ct 0st),0.68,WI,1990,2006
38,A Flower,1992-2002,63,110,160,151,9,142,9,5 (5ct 0st),1.454,ZIM,1992,2002
39,MA Taylor,1989-1999,104,197,157,157,0,0,157,4 (4ct 0st),0.7959999999999999,AUS,1989,1999
40,AR Border,1978-1994,156,277,156,156,0,0,156,4 (4ct 0st),0.563,AUS,1978,1994
41,HAPW Jayawardene,2000-2015,58,102,156,124,32,124,0,5 (5ct 0st),1.529,SL,2000,2015
42,DJ Richardson,1992-1998,42,77,152,150,2,150,0,5 (5ct 0st),1.974,SA,1992,1998
43,Moin Khan,1990-2004,69,124,148,128,20,127,1,5 (4ct 1st),1.193,PAK,1990,2004
44,LRPL Taylor,2007-2019,98,184,143,143,0,0,143,3 (3ct 0st),0.777,NZ,2007,2019
45,JHB Waite,1951-1965,50,94,141,124,17,124,0,4 (4ct 0st),1.5,SA,1951,1965
46,Younis Khan,2000-2017,118,221,139,139,0,0,139,4 (4ct 0st),0.628,PAK,2000,2017
47,TD Paine,2010-2019,30,58,137,131,6,131,0,5 (5ct 0st),2.362,AUS,2010,2019
48,VVS Laxman,1996-2012,134,248,135,135,0,0,135,4 (4ct 0st),0.544,INDIA,1996,2012
49,MJ Clarke,2004-2015,115,223,134,134,0,0,134,3 (3ct 0st),0.6,AUS,2004,2015
50,GO Jones,2004-2006,34,66,133,128,5,128,0,6 (6ct 0st),2.015,ENG,2004,2006
51,KS More,1986-1993,49,90,130,110,20,110,0,5 (0ct 5st),1.444,INDIA,1986,1993
52,WAS Oldfield,1920-1937,54,101,130,78,52,78,0,5 (1ct 4st),1.287,AUS,1920,1937
53,Rashid Latif,1992-2003,37,69,130,119,11,119,0,6 (6ct 0st),1.884,PAK,1992,2003
54,ML Hayden,1994-2009,103,205,128,128,0,0,128,4 (4ct 0st),0.624,AUS,1994,2009
55,SK Warne,1992-2007,145,281,125,125,0,0,125,3 (3ct 0st),0.444,AUS,1992,2007
56,HP Tillakaratne,1989-2004,83,141,124,122,2,33,89,5 (5ct 0st),0.879,SL,1989,2004
57,GS Chappell,1970-1984,87,165,122,122,0,0,122,4 (4ct 0st),0.7390000000000001,AUS,1970,1984
58,IVA Richards,1974-1991,121,232,122,122,0,0,122,4 (4ct 0st),0.525,WI,1974,1991
59,AJ Strauss,2004-2012,100,189,121,121,0,0,121,3 (3ct 0st),0.64,ENG,2004,2012
60,IT Botham,1977-1992,102,179,120,120,0,0,120,3 (3ct 0st),0.67,ENG,1977,1992
61,MC Cowdrey,1954-1975,114,214,120,120,0,0,120,3 (3ct 0st),0.56,ENG,1954,1975
62,RS Kaluwitharana,1992-2004,49,87,119,93,26,93,0,5 (5ct 0st),1.367,SL,1992,2004
63,Mushfiqur Rahim,2005-2019,69,118,118,103,15,98,5,5 (5ct 0st),1.0,BDESH,2005,2019
64,SPD Smith,2010-2019,72,137,117,117,0,0,117,5 (5ct 0st),0.8540000000000001,AUS,2010,2019
65,CL Hooper,1987-2002,102,189,115,115,0,0,115,4 (4ct 0st),0.608,WI,1987,2002
66,SR Tendulkar,1989-2013,200,366,115,115,0,0,115,3 (3ct 0st),0.314,INDIA,1989,2013
67,JM Parks,1954-1968,46,86,114,103,11,101,2,5 (5ct 0st),1.325,ENG,1954,1968
68,SR Waugh,1985-2004,168,318,112,112,0,0,112,3 (3ct 0st),0.352,AUS,1985,2004
69,WR Hammond,1927-1947,85,154,110,110,0,0,110,3 (3ct 0st),0.7140000000000001,ENG,1927,1947
70,JE Root,2012-2019,89,168,110,110,0,0,110,4 (4ct 0st),0.654,ENG,2012,2019
71,RB Simpson,1957-1978,62,117,110,110,0,0,110,4 (4ct 0st),0.94,AUS,1957,1978
72,GS Sobers,1954-1974,93,172,109,109,0,0,109,4 (4ct 0st),0.633,WI,1954,1974
73,HM Amla,2004-2019,124,234,108,108,0,0,108,3 (3ct 0st),0.461,SA,2004,2019
74,SM Gavaskar,1971-1987,125,216,108,108,0,0,108,3 (3ct 0st),0.5,INDIA,1971,1987
75,NR Mongia,1994-2001,44,77,107,99,8,99,0,5 (5ct 0st),1.389,INDIA,1994,2001
76,M Azharuddin,1984-2000,99,177,105,105,0,0,105,5 (5ct 0st),0.593,INDIA,1984,2000
77,IM Chappell,1964-1980,75,144,105,105,0,0,105,4 (4ct 0st),0.7290000000000001,AUS,1964,1980
78,GP Thorpe,1993-2005,100,179,105,105,0,0,105,4 (4ct 0st),0.586,ENG,1993,2005
79,Saleem Yousuf,1982-1990,32,58,104,91,13,91,0,5 (5ct 0st),1.793,PAK,1982,1990
80,GA Gooch,1975-1995,118,211,103,103,0,0,103,3 (3ct 0st),0.488,ENG,1975,1995
81,WP Saha,2010-2019,37,71,103,92,11,92,0,6 (5ct 1st),1.45,INDIA,2010,2019
82,JR Murray,1993-2002,33,61,102,99,3,98,1,5 (5ct 0st),1.672,WI,1993,2002
83,N Dickwella,2014-2019,35,63,101,81,20,80,1,5 (5ct 0st),1.6030000000000002,SL,2014,2019
84,IR Bell,2004-2015,118,223,100,100,0,0,100,3 (3ct 0st),0.4479999999999999,ENG,2004,2015
85,DC Boon,1984-1996,107,195,99,99,0,0,99,4 (4ct 0st),0.507,AUS,1984,1996
86,GRA Langley,1951-1956,26,51,98,83,15,83,0,5 (5ct 0st),1.921,AUS,1951,1956
87,LEG Ames,1929-1939,47,87,97,74,23,72,2,4 (4ct 0st),1.114,ENG,1929,1939
88,PD Collingwood,2003-2011,68,124,96,96,0,1,95,4 (4ct 0st),0.774,ENG,2003,2011
89,CH Gayle,2000-2014,103,190,96,96,0,0,96,3 (3ct 0st),0.505,WI,2000,2014
90,CG Greenidge,1974-1991,108,208,96,96,0,0,96,3 (3ct 0st),0.461,WI,1974,1991
91,KJ Wadsworth,1969-1976,33,59,96,92,4,92,0,5 (5ct 0st),1.6269999999999998,NZ,1969,1976
92,ME Trescothick,2000-2006,76,139,95,95,0,0,95,4 (4ct 0st),0.6829999999999999,ENG,2000,2006
93,HH Gibbs,1996-2008,90,173,94,94,0,0,94,4 (4ct 0st),0.5429999999999999,SA,1996,2008
94,Javed Miandad,1976-1993,124,218,94,93,1,0,93,3 (3ct 0st),0.431,PAK,1976,1993
95,Imtiaz Ahmed,1952-1962,41,69,93,77,16,74,3,5 (4ct 1st),1.347,PAK,1952,1962
96,AFA Lilley,1896-1909,35,67,92,70,22,70,0,4 (4ct 0st),1.3730000000000002,ENG,1896,1909
97,JM Anderson,2003-2019,150,284,91,91,0,0,91,3 (3ct 0st),0.32,ENG,2003,2019
98,V Sehwag,2001-2013,104,192,91,91,0,0,91,3 (3ct 0st),0.473,INDIA,2001,2013
99,FCM Alexander,1957-1961,25,47,90,85,5,85,0,5 (5ct 0st),1.914,WI,1957,1961
100,GA Hick,1991-2001,65,115,90,90,0,0,90,4 (4ct 0st),0.782,ENG,1991,2001
101,CH Lloyd,1966-1985,110,209,90,90,0,0,90,2 (2ct 0st),0.43,WI,1966,1985
102,RB Richardson,1983-1995,86,164,90,90,0,0,90,3 (3ct 0st),0.5479999999999999,WI,1983,1995
103,TM Dilshan,1999-2013,87,159,88,88,0,11,77,4 (4ct 0st),0.5529999999999999,SL,1999,2013
104,LD Chandimal,2011-2019,55,102,87,77,10,62,15,6 (5ct 1st),0.852,SL,2011,2019
105,AW Greig,1972-1977,58,107,87,87,0,0,87,4 (4ct 0st),0.813,ENG,1972,1977
106,Khaled Mashud,2000-2007,44,61,87,78,9,78,0,4 (4ct 0st),1.426,BDESH,2000,2007
107,MEK Hussey,2005-2013,79,153,85,85,0,0,85,3 (3ct 0st),0.555,AUS,2005,2013
108,MA Atherton,1989-2001,115,200,83,83,0,0,83,3 (3ct 0st),0.415,ENG,1989,2001
109,SO Dowrich,2015-2019,31,54,83,78,5,78,0,4 (4ct 0st),1.537,WI,2015,2019
110,G Kirsten,1993-2004,101,191,83,83,0,0,83,4 (4ct 0st),0.434,SA,1993,2004
111,IR Redpath,1964-1976,66,123,83,83,0,0,83,3 (3ct 0st),0.674,AUS,1964,1976
112,FM Engineer,1961-1975,46,83,82,66,16,66,0,3 (3ct 0st),0.987,INDIA,1961,1975
113,CO Browne,1995-2005,20,36,81,79,2,79,0,5 (5ct 0st),2.25,WI,1995,2005
114,Inzamam-ul-Haq,1992-2007,120,219,81,81,0,0,81,4 (4ct 0st),0.369,PAK,1992,2007
115,TW Graveney,1951-1969,79,152,80,80,0,2,78,3 (3ct 0st),0.526,ENG,1951,1969
116,V Kohli,2011-2019,84,160,80,80,0,0,80,3 (3ct 0st),0.5,INDIA,2011,2019
117,AM Rahane,2013-2019,63,120,80,80,0,0,80,5 (5ct 0st),0.6659999999999999,INDIA,2013,2019
118,MS Wade,2012-2019,31,60,80,69,11,63,6,5 (4ct 1st),1.3330000000000002,AUS,2012,2019
119,JC Buttler,2014-2019,38,72,79,79,0,56,23,5 (5ct 0st),1.097,ENG,2014,2019
120,ST Jayasuriya,1991-2007,110,196,78,78,0,0,78,3 (3ct 0st),0.397,SL,1991,2007
121,DB Vengsarkar,1976-1992,116,202,78,78,0,0,78,4 (4ct 0st),0.386,INDIA,1976,1992
122,Adnan Akmal,2010-2014,21,41,77,66,11,66,0,6 (6ct 0st),1.878,PAK,2010,2014
123,PR Downton,1981-1988,30,51,75,70,5,70,0,4 (4ct 0st),1.47,ENG,1981,1988
124,AJ Lamb,1982-1992,79,146,75,75,0,0,75,4 (4ct 0st),0.513,ENG,1982,1992
125,DI Gower,1978-1992,117,211,74,74,0,0,74,3 (3ct 0st),0.35,ENG,1978,1992
126,JL Langer,1993-2007,105,206,73,73,0,0,73,2 (2ct 0st),0.354,AUS,1993,2007
127,H Strudwick,1910-1926,28,50,73,61,12,61,0,4 (2ct 2st),1.46,ENG,1910,1926
128,M Muralitharan,1992-2010,133,233,72,72,0,0,72,2 (2ct 0st),0.309,SL,1992,2010
129,PA Patel,2002-2018,25,47,72,62,10,62,0,4 (4ct 0st),1.531,INDIA,2002,2018
130,SM Pollock,1995-2008,108,205,72,72,0,0,72,3 (3ct 0st),0.351,SA,1995,2008
131,Asad Shafiq,2010-2019,73,138,71,71,0,0,71,3 (3ct 0st),0.514,PAK,2010,2019
132,MD Crowe,1982-1995,77,130,71,71,0,0,71,4 (4ct 0st),0.546,NZ,1982,1995
133,SC Ganguly,1996-2008,113,208,71,71,0,0,71,3 (3ct 0st),0.341,INDIA,1996,2008
134,KS Williamson,2010-2019,78,147,71,71,0,0,71,3 (3ct 0st),0.482,NZ,2010,2019
135,NJ Astle,1996-2006,81,147,70,70,0,0,70,2 (2ct 0st),0.476,NZ,1996,2006
136,Majid Khan,1964-1983,63,116,70,70,0,5,65,4 (4ct 0st),0.603,PAK,1964,1983
137,DA Warner,2011-2019,83,160,68,68,0,1,67,4 (4ct 0st),0.425,AUS,2011,2019
138,DJ Cullinan,1993-2001,70,130,67,67,0,0,67,3 (3ct 0st),0.515,SA,1993,2001
139,N Hussain,1990-2004,96,165,67,67,0,0,67,3 (3ct 0st),0.406,ENG,1990,2004
140,S Chanderpaul,1994-2015,164,297,66,66,0,0,66,2 (2ct 0st),0.222,WI,1994,2015
141,AD Mathews,2009-2019,84,152,66,66,0,0,66,3 (3ct 0st),0.434,SL,2009,2019
142,R Benaud,1952-1964,63,122,65,65,0,0,65,3 (3ct 0st),0.532,AUS,1952,1964
143,H Carter,1907-1921,28,55,65,44,21,44,0,4 (4ct 0st),1.181,AUS,1907,1921
144,DL Haynes,1978-1994,116,221,65,65,0,0,65,2 (2ct 0st),0.294,WI,1978,1994
145,Mohammad Yousuf,1998-2010,90,168,65,65,0,0,65,3 (3ct 0st),0.386,PAK,1998,2010
146,Saleem Malik,1982-1999,103,184,65,65,0,0,65,3 (3ct 0st),0.353,PAK,1982,1999
147,DJG Sammy,2007-2013,38,68,65,65,0,0,65,5 (5ct 0st),0.955,WI,2007,2013
148,JV Coney,1974-1987,52,97,64,64,0,0,64,3 (3ct 0st),0.659,NZ,1974,1987
149,RN Harvey,1948-1963,79,152,64,64,0,0,64,4 (4ct 0st),0.421,AUS,1948,1963
150,N Kapil Dev,1978-1994,131,230,64,64,0,0,64,2 (2ct 0st),0.278,INDIA,1978,1994
151,FS Trueman,1952-1965,67,128,64,64,0,0,64,3 (3ct 0st),0.5,ENG,1952,1965
152,CL Walcott,1948-1960,44,82,64,53,11,27,26,4 (3ct 1st),0.78,WI,1948,1960
153,FE Woolley,1909-1934,64,113,64,64,0,1,63,4 (4ct 0st),0.5660000000000001,ENG,1909,1934
154,KD Karthik,2004-2018,26,49,63,57,6,51,6,4 (4ct 0st),1.285,INDIA,2004,2018
155,JJ Kelly,1896-1905,36,67,63,43,20,43,0,4 (4ct 0st),0.94,AUS,1896,1905
156,BKG Mendis,2015-2019,42,76,63,63,0,5,58,4 (4ct 0st),0.828,SL,2015,2019
157,PM Nevill,2015-2016,17,31,63,61,2,61,0,4 (4ct 0st),2.032,AUS,2015,2016
158,GR Viswanath,1969-1983,91,159,63,63,0,0,63,3 (3ct 0st),0.396,INDIA,1969,1983
159,D Elgar,2012-2019,60,111,62,62,0,0,62,2 (2ct 0st),0.5579999999999999,SA,2012,2019
160,RC Fredericks,1968-1977,59,112,62,62,0,0,62,4 (4ct 0st),0.5529999999999999,WI,1968,1977
161,DA Murray,1978-1982,19,34,62,57,5,57,0,5 (5ct 0st),1.823,WI,1978,1982
162,KP Pietersen,2005-2014,104,193,62,62,0,0,62,3 (3ct 0st),0.321,ENG,2005,2014
163,BA Stokes,2013-2019,60,114,62,62,0,0,62,3 (3ct 0st),0.5429999999999999,ENG,2013,2019
164,T Taibu,2001-2012,28,42,62,57,5,55,2,4 (4ct 0st),1.476,ZIM,2001,2012
165,Azhar Ali,2010-2019,77,145,61,61,0,0,61,3 (3ct 0st),0.42,PAK,2010,2019
166,JM Blackham,1877-1894,35,62,61,37,24,35,2,4 (2ct 2st),0.983,AUS,1877,1894
167,MA Butcher,1997-2004,71,122,61,61,0,0,61,3 (3ct 0st),0.5,ENG,1997,2004
168,ADR Campbell,1992-2002,60,105,60,60,0,0,60,3 (3ct 0st),0.5710000000000001,ZIM,1992,2002
169,G Duckworth,1924-1936,24,43,60,45,15,45,0,4 (4ct 0st),1.395,ENG,1924,1936
170,A Kumble,1990-2008,132,242,60,60,0,0,60,2 (2ct 0st),0.247,INDIA,1990,2008
171,W Rhodes,1899-1930,58,110,60,60,0,0,60,4 (4ct 0st),0.545,ENG,1899,1930
172,HB Taber,1966-1970,16,30,60,56,4,56,0,5 (5ct 0st),2.0,AUS,1966,1970
173,MW Gatting,1978-1995,79,135,59,59,0,0,59,3 (3ct 0st),0.437,ENG,1978,1995
174,WK Lees,1976-1983,21,42,59,52,7,52,0,5 (5ct 0st),1.404,NZ,1976,1983
175,DT Lindsay,1963-1970,19,36,59,57,2,54,3,6 (6ct 0st),1.638,SA,1963,1970
176,GAR Lock,1952-1968,49,93,59,59,0,0,59,3 (3ct 0st),0.634,ENG,1952,1968
177,MS Atapattu,1990-2007,90,159,58,58,0,0,58,3 (3ct 0st),0.364,SL,1990,2007
178,KF Barrington,1955-1968,82,153,58,58,0,0,58,3 (3ct 0st),0.379,ENG,1955,1968
179,D Tallon,1946-1953,21,42,58,50,8,50,0,4 (4ct 0st),1.38,AUS,1946,1953
180,DL Vettori,1997-2014,113,205,58,58,0,0,58,3 (3ct 0st),0.282,NZ,1997,2014
181,L Hutton,1937-1955,79,147,57,57,0,0,57,3 (3ct 0st),0.387,ENG,1937,1955
182,AL Logie,1983-1991,52,98,57,57,0,0,57,4 (4ct 0st),0.581,WI,1983,1991
183,F du Plessis,2012-2019,62,115,56,56,0,0,56,3 (3ct 0st),0.486,SA,2012,2019
184,RS Mahanama,1986-1998,52,81,56,56,0,0,56,4 (4ct 0st),0.691,SL,1986,1998
185,B Mitchell,1929-1949,42,71,56,56,0,0,56,4 (4ct 0st),0.7879999999999999,SA,1929,1949
186,JT Murray,1961-1967,21,38,55,52,3,52,0,6 (6ct 0st),1.4469999999999998,ENG,1961,1967
187,KWR Fletcher,1968-1982,59,106,54,54,0,0,54,3 (3ct 0st),0.509,ENG,1968,1982
188,BN Jarman,1959-1969,19,36,54,50,4,50,0,4 (4ct 0st),1.5,AUS,1959,1969
189,ND McKenzie,2000-2009,58,111,54,54,0,0,54,3 (3ct 0st),0.486,SA,2000,2009
190,CMW Read,1999-2007,15,26,54,48,6,48,0,6 (6ct 0st),2.076,ENG,1999,2007
191,GP Swann,2008-2013,60,113,54,54,0,0,54,3 (3ct 0st),0.477,ENG,2008,2013
192,BA Young,1993-1999,35,58,54,54,0,0,54,3 (3ct 0st),0.931,NZ,1993,1999
193,RR Pant,2018-2019,11,22,53,51,2,51,0,6 (6ct 0st),2.4090000000000003,INDIA,2018,2019
194,RR Sarwan,2000-2011,87,162,53,53,0,0,53,2 (2ct 0st),0.327,WI,2000,2011
195,MJK Smith,1958-1972,50,91,53,53,0,0,53,3 (3ct 0st),0.5820000000000001,ENG,1958,1972
196,ED Solkar,1969-1977,27,50,53,53,0,0,53,4 (4ct 0st),1.06,INDIA,1969,1977
197,JM Brearley,1976-1981,39,75,52,52,0,0,52,3 (3ct 0st),0.693,ENG,1976,1981
198,A Flintoff,1998-2009,79,144,52,52,0,0,52,3 (3ct 0st),0.361,ENG/ICC,1998,2009
199,LR Gibbs,1958-1976,79,151,52,52,0,0,52,3 (3ct 0st),0.344,WI,1958,1976
200,WB Phillips,1983-1986,27,43,52,52,0,43,9,5 (5ct 0st),1.209,AUS,1983,1986
201,TG Southee,2008-2019,71,135,52,52,0,0,52,2 (2ct 0st),0.385,NZ,2008,2019
202,RP Arnold,1997-2004,44,77,51,51,0,0,51,4 (4ct 0st),0.662,SL,1997,2004
203,DM Bravo,2010-2019,54,94,51,51,0,0,51,5 (5ct 0st),0.542,WI,2010,2019
204,HB Cameron,1927-1935,26,45,51,39,12,39,0,4 (2ct 2st),1.133,SA,1927,1935
205,AE Dick,1961-1965,17,30,51,47,4,47,0,4 (4ct 0st),1.7,NZ,1961,1965
206,AI Kallicharran,1972-1981,66,124,51,51,0,0,51,2 (2ct 0st),0.411,WI,1972,1981
207,NS Tamhane,1955-1961,21,35,51,35,16,35,0,4 (4ct 0st),1.457,INDIA,1955,1961
208,MJ Guptill,2009-2016,47,88,50,50,0,0,50,3 (3ct 0st),0.568,NZ,2009,2016
209,KJ Hughes,1977-1984,70,126,50,50,0,0,50,3 (3ct 0st),0.396,AUS,1977,1984
210,RB Kanhai,1957-1974,79,147,50,50,0,6,44,3 (3ct 0st),0.34,WI,1957,1974
211,FDM Karunaratne,2012-2019,64,118,50,50,0,0,50,3 (3ct 0st),0.423,SL,2012,2019
212,Misbah-ul-Haq,2001-2017,75,143,50,50,0,0,50,3 (3ct 0st),0.349,PAK,2001,2017
213,CA Pujara,2010-2019,75,144,50,50,0,0,50,3 (3ct 0st),0.347,INDIA,2010,2019
214,DCS Compton,1937-1957,78,146,49,49,0,0,49,2 (2ct 0st),0.335,ENG,1937,1957
215,BM McMillan,1992-1998,38,70,49,49,0,0,49,3 (3ct 0st),0.7,SA,1992,1998
216,SJ Rhodes,1994-1995,11,22,49,46,3,46,0,4 (4ct 0st),2.227,ENG,1994,1995
217,M Vijay,2008-2018,61,115,49,49,0,0,49,2 (2ct 0st),0.426,INDIA,2008,2018
218,ED Weekes,1948-1958,48,90,49,49,0,0,49,4 (4ct 0st),0.544,WI,1948,1958
219,JC Adams,1992-2001,54,99,48,48,0,0,48,4 (4ct 0st),0.484,WI,1992,2001
220,CS Baugh,2003-2012,21,38,48,43,5,43,0,5 (4ct 1st),1.263,WI,2003,2012
221,TL Goddard,1955-1970,41,77,48,48,0,0,48,4 (4ct 0st),0.623,SA,1955,1970
222,TWM Latham,2014-2019,49,94,48,48,0,7,41,3 (3ct 0st),0.51,NZ,2014,2019
223,Mudassar Nazar,1976-1989,76,133,48,48,0,0,48,2 (2ct 0st),0.36,PAK,1976,1989
224,Taufeeq Umar,2001-2014,44,83,48,48,0,4,44,4 (4ct 0st),0.578,PAK,2001,2014
225,M Amarnath,1969-1988,69,115,47,47,0,0,47,3 (3ct 0st),0.408,INDIA,1969,1988
226,SL Campbell,1995-2002,52,92,47,47,0,0,47,3 (3ct 0st),0.51,WI,1995,2002
227,JL Hendriks,1962-1969,20,37,47,42,5,42,0,4 (2ct 2st),1.27,WI,1962,1969
228,NM Lyon,2011-2019,95,184,47,47,0,0,47,2 (2ct 0st),0.255,AUS,2011,2019
229,AG Prince,2002-2011,66,124,47,47,0,0,47,3 (3ct 0st),0.379,SA,2002,2011
230,A Ranatunga,1982-2000,93,148,47,47,0,0,47,3 (3ct 0st),0.317,SL,1982,2000
231,SJ Rixon,1977-1985,13,24,47,42,5,42,0,4 (4ct 0st),1.958,AUS,1977,1985
232,KR Stackpole,1966-1974,43,83,47,47,0,0,47,3 (3ct 0st),0.5660000000000001,AUS,1966,1974
233,KL Rahul,2014-2019,36,70,46,46,0,1,45,4 (4ct 0st),0.657,INDIA,2014,2019
234,AL Wadekar,1966-1974,37,69,46,46,0,0,46,4 (4ct 0st),0.6659999999999999,INDIA,1966,1974
235,GS Blewett,1995-2000,46,90,45,45,0,0,45,3 (3ct 0st),0.5,AUS,1995,2000
236,SD Hope,2015-2019,31,56,45,44,1,9,35,5 (5ct 0st),0.8029999999999999,WI,2015,2019
237,Ijaz Ahmed,1987-2001,60,110,45,45,0,0,45,3 (3ct 0st),0.409,PAK,1987,2001
238,R Illingworth,1958-1973,61,115,45,45,0,0,45,3 (3ct 0st),0.391,ENG,1958,1973
239,Mohammad Hafeez,2003-2018,55,107,45,45,0,0,45,2 (2ct 0st),0.42,PAK,2003,2018
240,TT Samaraweera,2001-2013,81,145,45,45,0,0,45,3 (3ct 0st),0.31,SL,2001,2013
241,H Trumble,1890-1904,32,61,45,45,0,0,45,3 (3ct 0st),0.737,AUS,1890,1904
242,SR Watson,2005-2015,59,113,45,45,0,0,45,3 (3ct 0st),0.3979999999999999,AUS,2005,2015
243,WW Armstrong,1902-1921,50,96,44,44,0,0,44,2 (2ct 0st),0.4579999999999999,AUS,1902,1921
244,BE Congdon,1965-1978,61,110,44,44,0,1,43,3 (3ct 0st),0.4,NZ,1965,1978
245,JR Reid,1949-1965,58,90,44,43,1,4,39,3 (3ct 0st),0.488,NZ,1949,1965
246,DL Underwood,1966-1982,86,157,44,44,0,0,44,3 (3ct 0st),0.28,ENG,1966,1982
247,MP Vaughan,1999-2008,82,150,44,44,0,0,44,3 (3ct 0st),0.293,ENG,1999,2008
248,S Venkataraghavan,1965-1983,57,101,44,44,0,0,44,4 (4ct 0st),0.435,INDIA,1965,1983
249,Wasim Akram,1985-2002,104,186,44,44,0,0,44,3 (3ct 0st),0.236,PAK,1985,2002
250,SCJ Broad,2007-2019,135,253,43,43,0,0,43,2 (2ct 0st),0.1689999999999999,ENG,2007,2019
251,PA de Silva,1984-2002,93,149,43,43,0,0,43,4 (4ct 0st),0.288,SL,1984,2002
252,JH Edrich,1963-1976,77,145,43,43,0,0,43,2 (2ct 0st),0.296,ENG,1963,1976
253,GW Flower,1992-2004,67,114,43,43,0,0,43,3 (3ct 0st),0.377,ZIM,1992,2004
254,AW Nourse,1902-1924,45,78,43,43,0,0,43,4 (4ct 0st),0.551,SA,1902,1924
255,KD Walters,1965-1981,74,142,43,43,0,0,43,2 (2ct 0st),0.302,AUS,1965,1981
256,FMM Worrell,1948-1963,51,98,43,43,0,0,43,3 (3ct 0st),0.4379999999999999,WI,1948,1963
257,AK Davidson,1953-1963,44,85,42,42,0,0,42,4 (4ct 0st),0.494,AUS,1953,1963
258,PH Edmonds,1975-1987,51,91,42,42,0,0,42,4 (4ct 0st),0.461,ENG,1975,1987
259,J Garner,1977-1987,58,111,42,42,0,0,42,3 (3ct 0st),0.3779999999999999,WI,1977,1987
260,Harbhajan Singh,1998-2015,103,192,42,42,0,0,42,2 (2ct 0st),0.218,INDIA,1998,2015
261,Iqbal Qasim,1976-1988,50,89,42,42,0,0,42,3 (3ct 0st),0.471,PAK,1976,1988
262,PBH May,1951-1961,66,127,42,42,0,0,42,4 (4ct 0st),0.33,ENG,1951,1961
263,Mushtaq Mohammad,1959-1979,57,102,42,42,0,0,42,2 (2ct 0st),0.411,PAK,1959,1979
264,PH Parfitt,1961-1972,37,73,42,42,0,0,42,4 (4ct 0st),0.575,ENG,1961,1972
265,GM Turner,1969-1983,41,75,42,42,0,0,42,2 (2ct 0st),0.56,NZ,1969,1983
266,D Williams,1992-1998,11,19,42,40,2,40,0,5 (5ct 0st),2.21,WI,1992,1998
267,DJ Bravo,2004-2010,40,71,41,41,0,0,41,3 (3ct 0st),0.5770000000000001,WI,2004,2010
268,JJ Crowe,1983-1990,39,69,41,41,0,0,41,4 (4ct 0st),0.594,NZ,1983,1990
269,WR Endean,1951-1958,28,52,41,41,0,3,38,3 (3ct 0st),0.7879999999999999,SA,1951,1958
270,SJ McCabe,1930-1938,39,73,41,41,0,0,41,3 (3ct 0st),0.561,AUS,1930,1938
271,GM Wood,1978-1988,59,108,41,41,0,0,41,2 (2ct 0st),0.379,AUS,1978,1988
272,Hanif Mohammad,1952-1969,55,95,40,40,0,2,38,4 (4ct 0st),0.421,PAK,1952,1969
273,Imran Farhat,2001-2013,40,72,40,40,0,0,40,2 (2ct 0st),0.555,PAK,2001,2013
274,K Srikkanth,1981-1992,43,78,40,40,0,0,40,5 (5ct 0st),0.512,INDIA,1981,1992
275,LC Braund,1901-1908,23,44,39,39,0,0,39,4 (4ct 0st),0.8859999999999999,ENG,1901,1908
276,WJ Edrich,1938-1955,39,70,39,39,0,0,39,3 (3ct 0st),0.557,ENG,1938,1955
277,BN French,1986-1988,16,25,39,38,1,38,0,4 (4ct 0st),1.56,ENG,1986,1988
278,WG Grace,1880-1899,22,42,39,39,0,1,38,3 (3ct 0st),0.928,ENG,1880,1899
279,Sir RJ Hadlee,1973-1990,86,156,39,39,0,0,39,2 (2ct 0st),0.25,NZ,1973,1990
280,SM Katich,2001-2010,56,109,39,39,0,0,39,2 (2ct 0st),0.357,AUS,2001,2010
281,MR Ramprakash,1991-2002,52,93,39,39,0,0,39,3 (3ct 0st),0.419,ENG,1991,2002
282,RA Smith,1988-1996,62,110,39,39,0,0,39,3 (3ct 0st),0.354,ENG,1988,1996
283,RGD Willis,1971-1984,90,165,39,39,0,0,39,2 (2ct 0st),0.236,ENG,1971,1984
284,CPS Chauhan,1969-1981,40,71,38,38,0,0,38,3 (3ct 0st),0.535,INDIA,1969,1981
285,JP Duminy,2008-2017,46,83,38,38,0,0,38,3 (3ct 0st),0.457,SA,2008,2017
286,G Gambhir,2004-2016,58,104,38,38,0,0,38,2 (2ct 0st),0.365,INDIA,2004,2016
287,GD McGrath,1993-2007,124,244,38,38,0,0,38,2 (2ct 0st),0.155,AUS,1993,2007
288,Mahmudullah,2009-2019,48,84,38,37,1,0,37,3 (3ct 0st),0.452,BDESH,2009,2019
289,GR Marsh,1985-1992,50,89,38,38,0,0,38,2 (2ct 0st),0.426,AUS,1985,1992
290,KR Miller,1946-1956,55,105,38,38,0,0,38,2 (2ct 0st),0.361,AUS,1946,1956
291,JG Wright,1978-1993,82,145,38,38,0,0,38,3 (3ct 0st),0.262,NZ,1978,1993
292,CG Borde,1958-1969,55,96,37,37,0,0,37,3 (3ct 0st),0.385,INDIA,1958,1969
293,JM Gregory,1920-1928,24,44,37,37,0,0,37,3 (3ct 0st),0.84,AUS,1920,1928
294,Aamer Sohail,1992-2000,47,87,36,36,0,0,36,3 (3ct 0st),0.413,PAK,1992,2000
295,Asif Iqbal,1964-1980,58,110,36,36,0,0,36,2 (2ct 0st),0.327,PAK,1964,1980
296,TA Boult,2011-2019,65,123,36,36,0,0,36,2 (2ct 0st),0.292,NZ,2011,2019
297,RA Harper,1983-1993,25,49,36,36,0,0,36,3 (3ct 0st),0.7340000000000001,WI,1983,1993
298,AC Hudson,1992-1998,35,63,36,36,0,0,36,4 (4ct 0st),0.5710000000000001,SA,1992,1998
299,DR Martyn,1992-2006,67,130,36,36,0,0,36,2 (2ct 0st),0.276,AUS,1992,2006
300,RJ Shastri,1981-1992,80,140,36,36,0,0,36,2 (2ct 0st),0.257,INDIA,1981,1992
301,PW Sherwell,1906-1911,13,24,36,20,16,20,0,3 (3ct 0st),1.5,SA,1906,1911
302,DS Smith,2003-2018,43,79,36,36,0,0,36,3 (3ct 0st),0.455,WI,2003,2018
303,EJ Barlow,1961-1970,30,58,35,35,0,0,35,3 (3ct 0st),0.603,SA,1961,1970
304,Imrul Kayes,2008-2019,39,67,35,35,0,5,30,5 (5ct 0st),0.522,BDESH,2008,2019
305,UT Khawaja,2011-2019,44,83,35,35,0,0,35,3 (3ct 0st),0.421,AUS,2011,2019
306,GRJ Roope,1973-1978,21,37,35,35,0,0,35,3 (3ct 0st),0.945,ENG,1973,1978
307,JK Silva,2011-2018,39,75,35,34,1,6,28,2 (2ct 0st),0.466,SL,2011,2018
308,FJ Titmus,1955-1975,53,100,35,35,0,0,35,2 (2ct 0st),0.35,ENG,1955,1975
309,KJ Wright,1979-1979,10,16,35,31,4,31,0,5 (5ct 0st),2.187,AUS,1979,1979
310,MG Burgess,1968-1980,50,94,34,34,0,0,34,2 (2ct 0st),0.361,NZ,1968,1980
311,SV Carlisle,1995-2005,37,62,34,34,0,0,34,3 (3ct 0st),0.5479999999999999,ZIM,1995,2005
312,SS Das,2000-2002,23,43,34,34,0,0,34,3 (3ct 0st),0.79,INDIA,2000,2002
313,JE Emburey,1978-1995,64,109,34,34,0,0,34,2 (2ct 0st),0.311,ENG,1978,1995
314,RA Jadeja,2012-2019,48,93,34,34,0,0,34,3 (3ct 0st),0.365,INDIA,2012,2019
315,DM Jones,1984-1992,52,91,34,34,0,0,34,2 (2ct 0st),0.373,AUS,1984,1992
316,L Klusener,1996-2004,49,92,34,34,0,0,34,2 (2ct 0st),0.369,SA,1996,2004
317,GD McKenzie,1961-1971,60,113,34,34,0,0,34,2 (2ct 0st),0.3,AUS,1961,1971
318,Mohsin Khan,1978-1986,48,83,34,34,0,0,34,3 (3ct 0st),0.409,PAK,1978,1986
319,Rameez Raja,1984-1997,57,103,34,34,0,0,34,3 (3ct 0st),0.33,PAK,1984,1997
320,JN Rhodes,1992-2000,52,96,34,34,0,0,34,2 (2ct 0st),0.354,SA,1992,2000
321,SAR Silva,1983-1988,9,15,34,33,1,33,0,6 (6ct 0st),2.266,SL,1983,1988
322,Zaheer Abbas,1969-1985,78,139,34,34,0,0,34,3 (3ct 0st),0.244,PAK,1969,1985
323,G Boycott,1964-1982,108,193,33,33,0,0,33,2 (2ct 0st),0.17,ENG,1964,1982
324,WJ Cronje,1992-2000,68,128,33,33,0,0,33,2 (2ct 0st),0.257,SA,1992,2000
325,AF Giles,1998-2006,54,99,33,33,0,0,33,2 (2ct 0st),0.3329999999999999,ENG,1998,2006
326,AP Gurusinha,1985-1996,41,66,33,33,0,2,31,2 (2ct 0st),0.5,SL,1985,1996
327,EH Hendren,1920-1935,51,92,33,33,0,0,33,2 (2ct 0st),0.358,ENG,1920,1935
328,C Hill,1896-1912,49,93,33,33,0,0,33,3 (3ct 0st),0.354,AUS,1896,1912
329,JO Holder,2014-2019,40,70,33,33,0,0,33,3 (3ct 0st),0.471,WI,2014,2019
330,HJ Howarth,1969-1977,30,55,33,33,0,0,33,3 (3ct 0st),0.6,NZ,1969,1977
331,MH Mankad,1946-1959,44,72,33,33,0,0,33,3 (3ct 0st),0.4579999999999999,INDIA,1946,1959
332,MJ Slater,1993-2001,74,143,33,33,0,0,33,4 (4ct 0st),0.23,AUS,1993,2001
333,PR Umrigar,1948-1962,59,101,33,33,0,0,33,3 (3ct 0st),0.326,INDIA,1948,1962
334,S Abid Ali,1967-1974,29,53,32,32,0,0,32,3 (3ct 0st),0.603,INDIA,1967,1974
335,MM Ali,2014-2019,60,113,32,32,0,0,32,2 (2ct 0st),0.283,ENG,2014,2019
336,TE Bailey,1949-1959,61,118,32,32,0,0,32,2 (2ct 0st),0.271,ENG,1949,1959
337,DG Bradman,1928-1948,52,99,32,32,0,0,32,2 (2ct 0st),0.3229999999999999,AUS,1928,1948
338,APF Chapman,1924-1931,26,46,32,32,0,0,32,4 (4ct 0st),0.695,ENG,1924,1931
339,DM de Silva,2016-2019,29,52,32,32,0,0,32,3 (3ct 0st),0.615,SL,2016,2019
340,WW Hinds,2000-2005,45,83,32,32,0,0,32,3 (3ct 0st),0.385,WI,2000,2005
341,KR Rutherford,1985-1995,56,95,32,32,0,0,32,2 (2ct 0st),0.336,NZ,1985,1995
342,TA Ward,1912-1924,23,37,32,19,13,19,0,3 (3ct 0st),0.8640000000000001,SA,1912,1924
343,TR Ambrose,2008-2009,11,21,31,31,0,31,0,3 (3ct 0st),1.476,ENG,2008,2009
344,JG Bracewell,1980-1990,41,73,31,31,0,0,31,3 (3ct 0st),0.424,NZ,1980,1990
345,JT Ikin,1946-1955,18,32,31,31,0,0,31,3 (3ct 0st),0.968,ENG,1946,1955
346,AN Petersen,2010-2015,36,68,31,31,0,0,31,2 (2ct 0st),0.455,SA,2010,2015
347,DW Randall,1977-1984,47,88,31,31,0,0,31,2 (2ct 0st),0.352,ENG,1977,1984
348,PK Sen,1948-1952,14,21,31,20,11,20,0,4 (4ct 0st),1.476,INDIA,1948,1952
349,RG Sharma,2013-2019,32,63,31,31,0,0,31,3 (3ct 0st),0.492,INDIA,2013,2019
350,MS Sinclair,1999-2010,33,61,31,31,0,1,30,3 (3ct 0st),0.508,NZ,1999,2010
351,VT Trumper,1899-1912,48,90,31,31,0,0,31,2 (2ct 0st),0.344,AUS,1899,1912
352,WPUJC Vaas,1994-2009,111,196,31,31,0,0,31,2 (2ct 0st),0.158,SL,1994,2009
353,B Yardley,1978-1983,33,62,31,31,0,0,31,2 (2ct 0st),0.5,AUS,1978,1983
354,Yuvraj Singh,2003-2012,40,76,31,31,0,0,31,2 (2ct 0st),0.407,INDIA,2003,2012
355,BL Cairns,1974-1985,43,78,30,30,0,0,30,2 (2ct 0st),0.384,NZ,1974,1985
356,D Ganga,1998-2008,48,87,30,30,0,0,30,3 (3ct 0st),0.344,WI,1998,2008
357,RG Hart,2002-2003,11,18,30,29,1,29,0,4 (4ct 0st),1.666,NZ,2002,2003
358,AL Hassett,1938-1953,43,82,30,30,0,0,30,2 (2ct 0st),0.365,AUS,1938,1953
359,IWG Johnson,1946-1956,45,86,30,30,0,0,30,3 (3ct 0st),0.348,AUS,1946,1956
360,BK Kunderan,1960-1967,18,31,30,23,7,21,2,5 (3ct 2st),0.967,INDIA,1960,1967
361,WM Lawry,1961-1971,67,127,30,30,0,0,30,2 (2ct 0st),0.236,AUS,1961,1971
362,AA Mallett,1968-1980,38,73,30,30,0,0,30,2 (2ct 0st),0.41,AUS,1968,1980
363,FLH Mooney,1949-1954,14,23,30,22,8,22,0,4 (3ct 1st),1.304,NZ,1949,1954
364,JM Parker,1973-1980,36,65,30,30,0,0,30,3 (3ct 0st),0.461,NZ,1973,1980
365,H Verity,1931-1939,40,75,30,30,0,0,30,2 (2ct 0st),0.4,ENG,1931,1939
366,KC Wessels,1982-1994,40,70,30,30,0,0,30,2 (2ct 0st),0.428,AUS/SA,1982,1994
367,PR Adams,1995-2004,45,85,29,29,0,0,29,3 (3ct 0st),0.341,SA,1995,2004
368,JP Crawley,1994-2003,37,65,29,29,0,0,29,2 (2ct 0st),0.446,ENG,1994,2003
369,ER Dexter,1958-1968,62,116,29,29,0,0,29,2 (2ct 0st),0.25,ENG,1958,1968
370,BL D'Oliveira,1966-1972,44,83,29,29,0,0,29,3 (3ct 0st),0.349,ENG,1966,1972
371,LK Germon,1995-1997,12,19,29,27,2,27,0,4 (4ct 0st),1.526,NZ,1995,1997
372,GP Howarth,1975-1985,47,86,29,29,0,0,29,2 (2ct 0st),0.337,NZ,1975,1985
373,Liton Das,2015-2019,18,26,29,27,2,20,7,4 (3ct 1st),1.115,BDESH,2015,2019
374,AC MacLaren,1894-1909,35,64,29,29,0,0,29,2 (2ct 0st),0.4529999999999999,ENG,1894,1909
375,H Masakadza,2001-2018,38,63,29,29,0,0,29,3 (3ct 0st),0.46,ZIM,2001,2018
376,Mominul Haque,2013-2019,38,63,29,29,0,0,29,3 (3ct 0st),0.46,BDESH,2013,2019
377,KOA Powell,2011-2018,40,72,29,29,0,0,29,3 (3ct 0st),0.402,WI,2011,2018
378,JA Rudolph,2003-2012,48,92,29,29,0,0,29,2 (2ct 0st),0.315,SA,2003,2012
379,A Shrewsbury snr,1881-1893,23,42,29,29,0,0,29,3 (3ct 0st),0.69,ENG,1881,1893
380,IJL Trott,2009-2015,52,99,29,29,0,0,29,2 (2ct 0st),0.292,ENG,2009,2015
381,CA Walsh,1984-2001,132,244,29,29,0,0,29,2 (2ct 0st),0.118,WI,1984,2001
382,RW Chakabva,2011-2018,14,25,28,25,3,24,1,4 (4ct 0st),1.12,ZIM,2011,2018
383,LN Constantine,1928-1939,18,29,28,28,0,0,28,3 (3ct 0st),0.965,WI,1928,1939
384,MH Denness,1969-1975,28,50,28,28,0,0,28,2 (2ct 0st),0.56,ENG,1969,1975
385,S Dhawan,2013-2018,34,66,28,28,0,0,28,2 (2ct 0st),0.424,INDIA,2013,2018
386,PSP Handscomb,2016-2019,16,30,28,28,0,0,28,3 (3ct 0st),0.933,AUS,2016,2019
387,Imran Khan,1971-1992,88,158,28,28,0,0,28,3 (3ct 0st),0.177,PAK,1971,1992
388,GA Lohmann,1886-1896,18,36,28,28,0,0,28,3 (3ct 0st),0.777,ENG,1886,1896
389,Sadiq Mohammad,1969-1981,41,74,28,28,0,0,28,2 (2ct 0st),0.3779999999999999,PAK,1969,1981
390,MN Samuels,2000-2016,71,127,28,28,0,0,28,2 (2ct 0st),0.22,WI,2000,2016
391,MA Starc,2011-2019,56,109,28,28,0,0,28,2 (2ct 0st),0.256,AUS,2011,2019
392,JB Statham,1951-1965,70,134,28,28,0,0,28,2 (2ct 0st),0.208,ENG,1951,1965
393,TM Alderman,1981-1991,41,75,27,27,0,0,27,2 (2ct 0st),0.36,AUS,1981,1991
394,J Darling,1894-1905,34,63,27,27,0,0,27,3 (3ct 0st),0.428,AUS,1894,1905
395,HH Dippenaar,1999-2007,38,72,27,27,0,0,27,2 (2ct 0st),0.375,SA,1999,2007
396,JN Gillespie,1996-2006,71,141,27,27,0,0,27,1 (1ct 0st),0.191,AUS,1996,2006
397,MJ Greatbatch,1988-1996,41,64,27,27,0,0,27,3 (3ct 0st),0.421,NZ,1988,1996
398,W Jaffer,2000-2008,31,58,27,27,0,0,27,3 (3ct 0st),0.465,INDIA,2000,2008
399,MG Johnson,2007-2015,73,141,27,27,0,0,27,4 (4ct 0st),0.191,AUS,2007,2015
400,PG Joshi,1951-1960,12,20,27,18,9,18,0,4 (2ct 2st),1.35,INDIA,1951,1960
401,NT Paranavitana,2009-2012,32,53,27,27,0,0,27,2 (2ct 0st),0.509,SL,2009,2012
402,MAK Pataudi,1961-1975,46,84,27,27,0,0,27,2 (2ct 0st),0.321,INDIA,1961,1975
403,MDKJ Perera,2015-2019,18,35,27,19,8,14,5,3 (3ct 0st),0.7709999999999999,SL,2015,2019
404,BRM Taylor,2004-2018,28,45,27,27,0,3,24,2 (2ct 0st),0.6,ZIM,2004,2018
405,CL Vincent,1927-1935,25,43,27,27,0,0,27,2 (2ct 0st),0.627,SA,1927,1935
406,SC Williams,1994-2002,31,53,27,27,0,0,27,2 (2ct 0st),0.509,WI,1994,2002
407,BS Bedi,1966-1979,67,121,26,26,0,0,26,1 (1ct 0st),0.214,INDIA,1966,1979
408,AV Bedser,1946-1955,51,93,26,26,0,0,26,2 (2ct 0st),0.2789999999999999,ENG,1946,1955
409,KC Brathwaite,2011-2019,59,104,26,26,0,0,26,2 (2ct 0st),0.25,WI,2011,2019
410,DR Jardine,1928-1934,22,42,26,26,0,0,26,3 (3ct 0st),0.619,ENG,1928,1934
411,NV Knight,1995-2001,17,31,26,26,0,0,26,4 (4ct 0st),0.838,ENG,1995,2001
412,RR Lindwall,1946-1960,61,117,26,26,0,0,26,2 (2ct 0st),0.222,AUS,1946,1960
413,SV Manjrekar,1987-1996,37,68,26,25,1,0,25,3 (3ct 0st),0.382,INDIA,1987,1996
414,MA Noble,1898-1909,42,79,26,26,0,0,26,3 (3ct 0st),0.3289999999999999,AUS,1898,1909
415,MH Richardson,2000-2004,38,68,26,26,0,0,26,2 (2ct 0st),0.382,NZ,2000,2004
416,Sarfraz Nawaz,1969-1984,55,98,26,26,0,0,26,3 (3ct 0st),0.265,PAK,1969,1984
417,PV Simmons,1988-1997,26,48,26,26,0,0,26,2 (2ct 0st),0.541,WI,1988,1997
418,DW Steyn,2004-2019,93,175,26,26,0,0,26,2 (2ct 0st),0.148,SA,2004,2019
419,RF Surti,1960-1969,26,47,26,26,0,0,26,3 (3ct 0st),0.5529999999999999,INDIA,1960,1969
420,R Swetman,1959-1960,11,19,26,24,2,24,0,4 (4ct 0st),1.368,ENG,1959,1960
421,HJ Tayfield,1949-1960,37,67,26,26,0,0,26,2 (2ct 0st),0.3879999999999999,SA,1949,1960
422,Anil Dalpat,1984-1985,9,15,25,22,3,22,0,3 (3ct 0st),1.666,PAK,1984,1985
423,BS Chandrasekhar,1964-1979,58,102,25,25,0,0,25,2 (2ct 0st),0.245,INDIA,1964,1979
424,PG Fulton,2006-2014,23,42,25,25,0,0,25,3 (3ct 0st),0.595,NZ,2006,2014
425,SE Gregory,1890-1912,58,107,25,25,0,0,25,2 (2ct 0st),0.233,AUS,1890,1912
426,M Hendrick,1974-1981,30,56,25,25,0,0,25,3 (3ct 0st),0.446,ENG,1974,1981
427,AH Jones,1987-1995,39,62,25,25,0,0,25,2 (2ct 0st),0.4029999999999999,NZ,1987,1995
428,CC Lewis,1990-1996,32,58,25,25,0,0,25,2 (2ct 0st),0.431,ENG,1990,1996
429,MD Marshall,1978-1991,81,153,25,25,0,0,25,2 (2ct 0st),0.163,WI,1978,1991
430,Mohammad Ashraful,2001-2013,61,91,25,25,0,0,25,2 (2ct 0st),0.2739999999999999,BDESH,2001,2013
431,M Morkel,2006-2018,86,160,25,25,0,0,25,2 (2ct 0st),0.156,SA,2006,2018
432,M Ntini,1998-2009,101,192,25,25,0,0,25,1 (1ct 0st),0.13,SA,1998,2009
433,EC Petrie,1955-1966,14,18,25,25,0,25,0,4 (4ct 0st),1.388,NZ,1955,1966
434,DL Amiss,1966-1977,50,90,24,24,0,0,24,2 (2ct 0st),0.266,ENG,1966,1977
435,R Ashwin,2011-2019,70,134,24,24,0,0,24,2 (2ct 0st),0.179,INDIA,2011,2019
436,J Blackwood,2014-2019,28,47,24,24,0,0,24,5 (5ct 0st),0.51,WI,2014,2019
437,DB Close,1949-1976,22,44,24,24,0,0,24,3 (3ct 0st),0.545,ENG,1949,1976
438,EJM Cowan,2011-2013,18,35,24,24,0,0,24,3 (3ct 0st),0.685,AUS,2011,2013
439,PB Dassanayake,1993-1994,11,14,24,19,5,19,0,5 (5ct 0st),1.714,SL,1993,1994
440,GC Dyer,1986-1988,6,11,24,22,2,22,0,4 (4ct 0st),2.181,AUS,1986,1988
441,G Giffen,1881-1896,31,55,24,24,0,0,24,3 (3ct 0st),0.436,AUS,1881,1896
442,HMRKB Herath,1999-2018,93,172,24,24,0,0,24,2 (2ct 0st),0.139,SL,1999,2018
443,MJ Hoggard,2000-2008,67,125,24,24,0,0,24,2 (2ct 0st),0.192,ENG,2000,2008
444,C Kelleway,1910-1928,26,47,24,24,0,0,24,3 (3ct 0st),0.51,AUS,1910,1928
445,Mohammad Wasim,1996-2000,18,32,24,22,2,1,21,2 (2ct 0st),0.75,PAK,1996,2000
446,VY Richardson,1924-1936,19,37,24,24,0,0,24,5 (5ct 0st),0.648,AUS,1924,1936
447,RA Saggers,1948-1950,6,11,24,16,8,16,0,4 (1ct 3st),2.181,AUS,1948,1950
448,Shakib Al Hasan,2007-2019,56,97,24,24,0,0,24,2 (2ct 0st),0.247,BDESH,2007,2019
449,SJ Snooke,1906-1923,26,47,24,24,0,0,24,2 (2ct 0st),0.51,SA,1906,1923
450,WU Tharanga,2005-2017,31,58,24,24,0,0,24,3 (3ct 0st),0.413,SL,2005,2017
451,CFK van Wyk,2012-2012,9,17,24,23,1,23,0,4 (4ct 0st),1.411,NZ,2012,2012
452,PJP Burge,1955-1966,42,78,23,23,0,0,23,2 (2ct 0st),0.294,AUS,1955,1966
453,RG de Alwis,1983-1988,11,14,23,21,2,21,0,4 (4ct 0st),1.642,SL,1983,1988
454,GT Dowling,1961-1972,39,71,23,23,0,0,23,3 (3ct 0st),0.3229999999999999,NZ,1961,1972
455,BF Hastings,1969-1976,31,54,23,23,0,0,23,3 (3ct 0st),0.425,NZ,1969,1976
456,MG Hughes,1985-1994,53,97,23,23,0,0,23,2 (2ct 0st),0.237,AUS,1985,1994
457,B Lee,1999-2008,76,151,23,23,0,0,23,2 (2ct 0st),0.152,AUS,1999,2008
458,DK Lillee,1971-1984,70,133,23,23,0,0,23,2 (2ct 0st),0.172,AUS,1971,1984
459,RA McLean,1951-1964,40,72,23,23,0,0,23,2 (2ct 0st),0.319,SA,1951,1964
460,SE Marsh,2011-2019,38,72,23,23,0,0,23,2 (2ct 0st),0.319,AUS,2011,2019
461,Mushtaq Ahmed,1990-2003,52,94,23,23,0,0,23,2 (2ct 0st),0.244,PAK,1990,2003
462,SK Raina,2010-2015,18,33,23,23,0,0,23,2 (2ct 0st),0.696,INDIA,2010,2015
463,SB Styris,2002-2007,29,51,23,23,0,0,23,3 (3ct 0st),0.45,NZ,2002,2007
464,H Sutcliffe,1924-1935,54,96,23,23,0,0,23,3 (3ct 0st),0.239,ENG,1924,1935
465,GN Yallop,1976-1984,39,69,23,23,0,0,23,2 (2ct 0st),0.3329999999999999,AUS,1976,1984
466,KLT Arthurton,1988-1995,33,62,22,22,0,0,22,2 (2ct 0st),0.354,WI,1988,1995
467,Ashraf Ali,1982-1987,8,14,22,17,5,17,0,4 (2ct 2st),1.571,PAK,1982,1987
468,GS Ballance,2014-2017,23,46,22,22,0,0,22,3 (3ct 0st),0.478,ENG,2014,2017
469,IM Barrow,1930-1939,11,16,22,17,5,16,1,3 (3ct 0st),1.375,WI,1930,1939
470,FR Brown,1931-1953,22,40,22,22,0,0,22,2 (2ct 0st),0.55,ENG,1931,1953
471,JA Burns,2014-2019,20,38,22,22,0,0,22,2 (2ct 0st),0.578,AUS,2014,2019
472,Faisal Iqbal,2001-2010,26,46,22,22,0,0,22,3 (3ct 0st),0.478,PAK,2001,2010
473,JDC Goddard,1948-1957,27,51,22,22,0,0,22,2 (2ct 0st),0.431,WI,1948,1957
474,Habibul Bashar,2000-2008,50,70,22,22,0,0,22,2 (2ct 0st),0.314,BDESH,2000,2008
475,MA Holding,1975-1987,60,114,22,22,0,0,22,2 (2ct 0st),0.192,WI,1975,1987
476,CD McMillan,1997-2005,55,99,22,22,0,0,22,1 (1ct 0st),0.222,NZ,1997,2005
477,W Mathias,1955-1962,21,36,22,22,0,0,22,4 (4ct 0st),0.611,PAK,1955,1962
478,RG Nadkarni,1955-1968,41,73,22,22,0,0,22,2 (2ct 0st),0.301,INDIA,1955,1968
479,CM Old,1972-1981,46,84,22,22,0,0,22,2 (2ct 0st),0.261,ENG,1972,1981
480,K Rabada,2015-2019,41,76,22,22,0,0,22,2 (2ct 0st),0.289,SA,2015,2019
481,Shoaib Mohammad,1983-1995,45,79,22,22,0,0,22,2 (2ct 0st),0.278,PAK,1983,1995
482,J Srinath,1991-2002,67,122,22,22,0,0,22,2 (2ct 0st),0.18,INDIA,1991,2002
483,A Symonds,2004-2008,26,52,22,22,0,0,22,3 (3ct 0st),0.423,AUS,2004,2008
484,AC Bannerman,1879-1893,28,49,21,21,0,0,21,2 (2ct 0st),0.428,AUS,1879,1893
485,RW Barber,1960-1968,28,49,21,21,0,0,21,2 (2ct 0st),0.428,ENG,1960,1968
486,TE Blain,1986-1994,11,17,21,19,2,18,1,4 (4ct 0st),1.235,NZ,1986,1994
487,AR Caddick,1993-2003,62,106,21,21,0,0,21,2 (2ct 0st),0.198,ENG,1993,2003
488,RJ Christiani,1948-1954,22,44,21,19,2,1,18,3 (1ct 2st),0.477,WI,1948,1954
489,RM Cowper,1964-1968,27,50,21,21,0,0,21,2 (2ct 0st),0.42,AUS,1964,1968
490,TM Findlay,1969-1973,10,17,21,19,2,19,0,4 (4ct 0st),1.235,WI,1969,1973
491,GB Hole,1951-1955,18,35,21,21,0,0,21,4 (4ct 0st),0.6,AUS,1951,1955
492,E Jones,1894-1902,19,34,21,21,0,0,21,3 (3ct 0st),0.617,AUS,1894,1902
493,RB McCosker,1975-1980,25,47,21,21,0,0,21,2 (2ct 0st),0.446,AUS,1975,1980
494,VL Manjrekar,1951-1965,55,96,21,19,2,2,17,2 (2ct 0st),0.218,INDIA,1951,1965
495,BAG Murray,1968-1971,13,25,21,21,0,0,21,2 (2ct 0st),0.84,NZ,1968,1971
496,HM Nicholls,2016-2019,31,58,21,21,0,0,21,2 (2ct 0st),0.362,NZ,2016,2019
497,SM Nurse,1960-1969,29,54,21,21,0,1,20,2 (2ct 0st),0.3879999999999999,WI,1960,1969
498,NCL O'Neill,1958-1965,42,82,21,21,0,0,21,2 (2ct 0st),0.256,AUS,1958,1965
499,DG Phadkar,1947-1959,31,50,21,21,0,0,21,2 (2ct 0st),0.42,INDIA,1947,1959
500,WH Ponsford,1924-1934,29,55,21,21,0,0,21,2 (2ct 0st),0.381,AUS,1924,1934
501,JA Raval,2016-2019,23,44,21,21,0,0,21,3 (3ct 0st),0.477,NZ,2016,2019
502,CJ Richards,1986-1988,8,15,21,20,1,20,0,5 (5ct 0st),1.4,ENG,1986,1988
503,I Sharma,2007-2019,96,177,21,21,0,0,21,2 (2ct 0st),0.118,INDIA,2007,2019
504,Soumya Sarkar,2015-2019,15,25,21,21,0,0,21,4 (4ct 0st),0.84,BDESH,2015,2019
505,CM Spearman,1995-2000,19,38,21,21,0,0,21,2 (2ct 0st),0.552,NZ,1995,2000
506,GHS Trott,1888-1898,24,44,21,21,0,0,21,2 (2ct 0st),0.477,AUS,1888,1898
507,GOB Allen,1930-1948,25,47,20,20,0,0,20,2 (2ct 0st),0.425,ENG,1930,1948
508,RG Archer,1953-1956,19,35,20,20,0,0,20,4 (4ct 0st),0.5710000000000001,AUS,1953,1956
509,D Bishoo,2011-2018,36,64,20,20,0,0,20,3 (3ct 0st),0.312,WI,2011,2018
510,GA Faulkner,1906-1924,25,44,20,20,0,0,20,3 (3ct 0st),0.4539999999999999,SA,1906,1924
511,Intikhab Alam,1959-1977,47,87,20,20,0,0,20,2 (2ct 0st),0.2289999999999999,PAK,1959,1977
512,LV Maddocks,1954-1956,7,11,20,19,1,19,0,4 (3ct 1st),1.818,AUS,1954,1956
513,RS Morton,2005-2008,15,26,20,20,0,0,20,2 (2ct 0st),0.769,WI,2005,2008
514,M Prabhakar,1984-1995,39,69,20,20,0,0,20,2 (2ct 0st),0.289,INDIA,1984,1995
515,GS Ramchand,1952-1960,33,57,20,20,0,0,20,3 (3ct 0st),0.35,INDIA,1952,1960
516,AC Smith,1962-1963,6,12,20,20,0,20,0,3 (3ct 0st),1.666,ENG,1962,1963
517,EJ Smith,1911-1913,11,20,20,17,3,16,1,3 (3ct 0st),1.0,ENG,1911,1913
518,JB Stollmeyer,1939-1955,32,63,20,20,0,0,20,2 (2ct 0st),0.317,WI,1939,1955
519,B Sutcliffe,1947-1965,42,61,20,20,0,0,20,2 (2ct 0st),0.327,NZ,1947,1965
520,CJ Tavare,1980-1989,31,56,20,20,0,0,20,1 (1ct 0st),0.357,ENG,1980,1989
521,HDRL Thirimanne,2011-2019,35,65,20,20,0,0,20,2 (2ct 0st),0.307,SL,2011,2019
522,JR Thomson,1972-1985,51,94,20,20,0,0,20,1 (1ct 0st),0.212,AUS,1972,1985
523,AEE Vogler,1906-1911,15,28,20,20,0,0,20,4 (4ct 0st),0.7140000000000001,SA,1906,1911
524,Wasim Raja,1973-1985,57,98,20,20,0,0,20,2 (2ct 0st),0.204,PAK,1973,1985
525,Yasir Hameed,2003-2010,25,47,20,20,0,0,20,2 (2ct 0st),0.425,PAK,2003,2010
526,Asif Mujtaba,1986-1997,25,44,19,19,0,0,19,2 (2ct 0st),0.431,PAK,1986,1997
527,Babar Azam,2016-2019,25,46,19,19,0,0,19,2 (2ct 0st),0.413,PAK,2016,2019
528,W Barnes,1880-1890,21,40,19,19,0,0,19,3 (3ct 0st),0.475,ENG,1880,1890
529,MD Bell,1998-2008,18,33,19,19,0,0,19,2 (2ct 0st),0.575,NZ,1998,2008
530,TW Hayward,1896-1909,35,67,19,19,0,0,19,2 (2ct 0st),0.283,ENG,1896,1909
531,Z Khan,2000-2014,92,173,19,19,0,0,19,2 (2ct 0st),0.109,INDIA,2000,2014
532,CJ McDermott,1984-1996,71,126,19,19,0,0,19,2 (2ct 0st),0.15,AUS,1984,1996
533,Mehidy Hasan Miraz,2016-2019,22,39,19,19,0,0,19,2 (2ct 0st),0.487,BDESH,2016,2019
534,R Mutumbami,2013-2014,6,12,19,17,2,17,0,5 (4ct 1st),1.5830000000000002,ZIM,2013,2014
535,MDK Perera,2014-2019,41,75,19,19,0,0,19,2 (2ct 0st),0.253,SL,2014,2019
536,V Pollard,1965-1973,32,57,19,19,0,0,19,3 (3ct 0st),0.3329999999999999,NZ,1965,1973
537,Shahriar Nafees,2005-2013,24,38,19,19,0,0,19,2 (2ct 0st),0.5,BDESH,2005,2013
538,PM Siddle,2008-2019,67,128,19,19,0,0,19,2 (2ct 0st),0.148,AUS,2008,2019
539,HW Taylor,1912-1932,42,69,19,19,0,0,19,2 (2ct 0st),0.275,SA,1912,1932
540,G Ulyett,1877-1890,25,47,19,19,0,0,19,3 (3ct 0st),0.4039999999999999,ENG,1877,1890
541,L Vincent,2001-2007,23,41,19,19,0,0,19,3 (3ct 0st),0.4629999999999999,NZ,2001,2007
542,GJ Whittall,1993-2002,46,81,19,19,0,0,19,3 (3ct 0st),0.2339999999999999,ZIM,1993,2002
543,Yasir Shah,2014-2019,38,72,19,19,0,0,19,2 (2ct 0st),0.263,PAK,2014,2019
544,TJ Zoehrer,1986-1987,10,16,19,18,1,18,0,3 (3ct 0st),1.187,AUS,1986,1987
545,DW Allan,1962-1966,5,10,18,15,3,15,0,3 (3ct 0st),1.8,WI,1962,1966
546,CEL Ambrose,1988-2000,98,182,18,18,0,0,18,1 (1ct 0st),0.098,WI,1988,2000
547,N Boje,2000-2006,43,80,18,18,0,0,18,2 (2ct 0st),0.225,SA,2000,2006
548,JW Burke,1951-1959,24,45,18,18,0,0,18,2 (2ct 0st),0.4,AUS,1951,1959
549,NJ Contractor,1955-1962,31,54,18,18,0,0,18,2 (2ct 0st),0.3329999999999999,INDIA,1955,1962
550,DG Cork,1995-2002,37,65,18,18,0,0,18,2 (2ct 0st),0.276,ENG,1995,2002
551,Danish Kaneria,2000-2010,61,115,18,18,0,0,18,1 (1ct 0st),0.156,PAK,2000,2010
552,AA Donald,1992-2002,72,134,18,18,0,0,18,2 (2ct 0st),0.134,SA,1992,2002
553,JS Foster,2001-2002,7,13,18,17,1,17,0,5 (5ct 0st),1.384,ENG,2001,2002
554,HA Gomes,1976-1987,60,112,18,18,0,0,18,1 (1ct 0st),0.16,WI,1976,1987
555,GE Gomez,1939-1954,29,58,18,18,0,0,18,3 (3ct 0st),0.31,WI,1939,1954
556,JR Hazlewood,2014-2019,51,96,18,18,0,0,18,2 (2ct 0st),0.187,AUS,2014,2019
557,GH Hirst,1897-1909,24,44,18,18,0,0,18,2 (2ct 0st),0.409,ENG,1897,1909
558,DAJ Holford,1966-1977,24,42,18,18,0,0,18,2 (2ct 0st),0.428,WI,1966,1977
559,JM How,2006-2009,19,32,18,18,0,0,18,2 (2ct 0st),0.562,NZ,2006,2009
560,AH Jarvis,1885-1895,11,19,18,9,9,8,1,3 (3ct 0st),0.947,AUS,1885,1895
561,DJ McGlew,1951-1962,34,63,18,18,0,0,18,3 (3ct 0st),0.285,SA,1951,1962
562,JA Maclean,1978-1979,4,8,18,18,0,18,0,5 (5ct 0st),2.25,AUS,1978,1979
563,EAS Prasanna,1962-1978,49,88,18,18,0,0,18,2 (2ct 0st),0.204,INDIA,1962,1978
564,S Ramesh,1999-2001,19,36,18,18,0,0,18,2 (2ct 0st),0.5,INDIA,1999,2001
565,Saeed Anwar,1990-2001,55,101,18,18,0,0,18,2 (2ct 0st),0.178,PAK,1990,2001
566,RO Schwarz,1906-1912,20,36,18,18,0,0,18,2 (2ct 0st),0.5,SA,1906,1912
567,Shoaib Malik,2001-2015,35,67,18,18,0,0,18,2 (2ct 0st),0.268,PAK,2001,2015
568,Waqar Younis,1989-2003,87,158,18,18,0,0,18,3 (3ct 0st),0.113,PAK,1989,2003
569,GP Wickramasinghe,1991-2001,40,65,18,18,0,0,18,2 (2ct 0st),0.276,SL,1991,2001
570,SFAF Bacchus,1978-1982,19,34,17,17,0,0,17,3 (3ct 0st),0.5,WI,1978,1982
571,T Bavuma,2014-2019,39,70,17,17,0,0,17,2 (2ct 0st),0.242,SA,2014,2019
572,AP Binns,1953-1956,5,10,17,14,3,14,0,3 (3ct 0st),1.7,WI,1953,1956
573,BC Booth,1961-1966,29,54,17,17,0,0,17,2 (2ct 0st),0.314,AUS,1961,1966
574,DG Brownlie,2011-2013,14,25,17,17,0,0,17,4 (4ct 0st),0.68,NZ,2011,2013
575,AN Connolly,1963-1971,29,55,17,17,0,0,17,2 (2ct 0st),0.309,AUS,1963,1971
576,CB Fry,1896-1912,26,47,17,17,0,0,17,2 (2ct 0st),0.361,ENG,1896,1912
577,JW Gleeson,1967-1972,29,56,17,17,0,0,17,2 (2ct 0st),0.303,AUS,1967,1972
578,CV Grimmett,1925-1936,37,71,17,17,0,0,17,2 (2ct 0st),0.239,AUS,1925,1936
579,JB Hobbs,1908-1930,61,110,17,17,0,0,17,2 (2ct 0st),0.154,ENG,1908,1930
580,MJ Horne,1997-2003,35,65,17,17,0,0,17,3 (3ct 0st),0.261,NZ,1997,2003
581,DL Houghton,1992-1997,22,40,17,17,0,0,17,3 (3ct 0st),0.425,ZIM,1992,1997
582,ML Jaisimha,1959-1971,39,72,17,17,0,0,17,1 (1ct 0st),0.236,INDIA,1959,1971
583,KK Jennings,2016-2019,17,32,17,17,0,0,17,4 (4ct 0st),0.531,ENG,2016,2019
584,RAS Lakmal,2010-2019,59,109,17,17,0,0,17,1 (1ct 0st),0.155,SL,2010,2019
585,CG Macartney,1907-1926,35,64,17,17,0,0,17,1 (1ct 0st),0.265,AUS,1907,1926
586,G MacGregor,1890-1893,8,15,17,14,3,14,0,3 (3ct 0st),1.133,ENG,1890,1893
587,GRJ Matthews,1983-1993,33,56,17,17,0,0,17,2 (2ct 0st),0.303,AUS,1983,1993
588,G Miller,1976-1984,34,62,17,17,0,0,17,2 (2ct 0st),0.2739999999999999,ENG,1976,1984
589,MJ North,2009-2010,21,40,17,17,0,0,17,2 (2ct 0st),0.425,AUS,2009,2010
590,BP Patel,1974-1977,21,37,17,17,0,0,17,3 (3ct 0st),0.4589999999999999,INDIA,1974,1977
591,R Peel,1884-1896,20,38,17,17,0,0,17,2 (2ct 0st),0.447,ENG,1884,1896
592,VD Philander,2011-2019,61,114,17,17,0,0,17,1 (1ct 0st),0.149,SA,2011,2019
593,RG Pollock,1963-1970,23,44,17,17,0,0,17,2 (2ct 0st),0.386,SA,1963,1970
594,LG Rowe,1972-1980,30,55,17,17,0,0,17,2 (2ct 0st),0.309,WI,1972,1980
595,J Ryder,1920-1929,20,36,17,17,0,0,17,3 (3ct 0st),0.472,AUS,1920,1929
596,PJ Sharpe,1963-1969,12,24,17,17,0,0,17,2 (2ct 0st),0.708,ENG,1963,1969
597,AP Sheahan,1967-1974,31,60,17,17,0,0,17,1 (1ct 0st),0.283,AUS,1967,1974
598,HH Streak,1993-2005,65,110,17,17,0,0,17,2 (2ct 0st),0.154,ZIM,1993,2005
599,WW Wade,1938-1950,11,18,17,15,2,15,0,3 (3ct 0st),0.944,SA,1938,1950
600,JT Ward,1964-1968,8,15,17,16,1,16,0,4 (4ct 0st),1.133,NZ,1964,1968
601,AJ Watkins,1948-1952,15,26,17,17,0,0,17,3 (3ct 0st),0.653,ENG,1948,1952
602,Aamer Malik,1987-1994,14,26,16,15,1,4,11,4 (4ct 0st),0.615,PAK,1987,1994
603,CT Bancroft,2017-2019,10,19,16,16,0,0,16,3 (3ct 0st),0.8420000000000001,AUS,2017,2019
604,AJ Bichel,1997-2003,19,38,16,16,0,0,16,2 (2ct 0st),0.421,AUS,1997,2003
605,GJ Bonnor,1880-1888,17,29,16,16,0,0,16,3 (3ct 0st),0.551,AUS,1880,1888
606,N Deonarine,2005-2013,18,33,16,16,0,0,16,3 (3ct 0st),0.484,WI,2005,2013
607,M Dillon,1997-2004,38,69,16,16,0,0,16,2 (2ct 0st),0.231,WI,1997,2004
608,SB Doull,1992-2000,32,53,16,16,0,0,16,2 (2ct 0st),0.301,NZ,1992,2000
609,DD Ebrahim,2001-2005,29,45,16,16,0,0,16,2 (2ct 0st),0.355,ZIM,2001,2005
610,ST Gabriel,2012-2019,45,79,16,16,0,0,16,2 (2ct 0st),0.2019999999999999,WI,2012,2019
611,KD Ghavri,1974-1981,39,69,16,16,0,0,16,2 (2ct 0st),0.231,INDIA,1974,1981
612,CC Griffith,1960-1969,28,52,16,16,0,0,16,2 (2ct 0st),0.307,WI,1960,1969
613,SC Guillen,1951-1956,8,15,16,13,3,13,0,3 (3ct 0st),1.0659999999999998,NZ/WI,1951,1956
614,AJ Hall,2002-2007,21,39,16,16,0,0,16,2 (2ct 0st),0.41,SA,2002,2007
615,Haroon Rasheed,1977-1983,23,41,16,16,0,0,16,2 (2ct 0st),0.39,PAK,1977,1983
616,PL Harris,2007-2011,37,69,16,16,0,0,16,2 (2ct 0st),0.231,SA,2007,2011
617,VA Holder,1969-1979,40,74,16,16,0,0,16,1 (1ct 0st),0.216,WI,1969,1979
618,CC Hunte,1958-1967,44,85,16,16,0,0,16,2 (2ct 0st),0.188,WI,1958,1967
619,FA Iredale,1894-1899,14,27,16,16,0,0,16,3 (3ct 0st),0.5920000000000001,AUS,1894,1899
620,KC James,1930-1933,11,16,16,11,5,11,0,2 (2ct 0st),1.0,NZ,1930,1933
621,WR James,1993-1994,4,7,16,16,0,16,0,5 (5ct 0st),2.285,ZIM,1993,1994
622,WA Johnston,1947-1955,40,79,16,16,0,0,16,2 (2ct 0st),0.2019999999999999,AUS,1947,1955
623,AH Kardar,1946-1958,26,45,16,16,0,0,16,2 (2ct 0st),0.355,INDIA/PAK,1946,1958
624,MS Kasprowicz,1996-2006,38,75,16,16,0,0,16,2 (2ct 0st),0.213,AUS,1996,2006
625,BM Laird,1979-1982,21,37,16,16,0,0,16,2 (2ct 0st),0.432,AUS,1979,1982
626,SCG MacGill,1998-2008,44,87,16,16,0,0,16,2 (2ct 0st),0.183,AUS,1998,2008
627,KD Mackay,1956-1963,37,71,16,16,0,0,16,2 (2ct 0st),0.225,AUS,1956,1963
628,MR Marsh,2014-2019,32,62,16,16,0,0,16,2 (2ct 0st),0.258,AUS,2014,2019
629,A Nel,2001-2008,36,69,16,16,0,0,16,2 (2ct 0st),0.231,SA,2001,2008
630,CS Pandit,1986-1992,5,9,16,14,2,11,3,4 (4ct 0st),1.777,INDIA,1986,1992
631,WW Read,1882-1893,18,35,16,16,0,0,16,2 (2ct 0st),0.457,ENG,1882,1893
632,P Roy,1951-1960,43,72,16,16,0,0,16,2 (2ct 0st),0.222,INDIA,1951,1960
633,V Sibanda,2003-2014,14,27,16,16,0,0,16,3 (3ct 0st),0.5920000000000001,ZIM,2003,2014
634,JA Snow,1965-1976,49,93,16,16,0,0,16,2 (2ct 0st),0.172,ENG,1965,1976
635,JT Tyldesley,1899-1909,31,59,16,16,0,0,16,1 (1ct 0st),0.271,ENG,1899,1909
636,RES Wyatt,1927-1937,40,74,16,16,0,0,16,2 (2ct 0st),0.216,ENG,1927,1937
637,UT Yadav,2011-2019,45,88,16,16,0,0,16,2 (2ct 0st),0.181,INDIA,2011,2019
638,Yashpal Sharma,1979-1983,37,60,16,16,0,0,16,2 (2ct 0st),0.266,INDIA,1979,1983
639,Abdul Qadir,1977-1990,67,117,15,15,0,0,15,2 (2ct 0st),0.128,PAK,1977,1990
640,Abdul Razzaq,1999-2006,46,85,15,15,0,0,15,2 (2ct 0st),0.176,PAK,1999,2006
641,BF Butcher,1958-1969,44,83,15,15,0,0,15,2 (2ct 0st),0.18,WI,1958,1969
642,AG Chipperfield,1934-1938,14,26,15,15,0,0,15,3 (3ct 0st),0.5760000000000001,AUS,1934,1938
643,A Chopra,2003-2004,10,19,15,15,0,0,15,3 (3ct 0st),0.789,INDIA,2003,2004
644,CI Dunusinghe,1995-1995,5,9,15,13,2,13,0,4 (4ct 0st),1.666,SL,1995,1995
645,KA Edwards,2011-2014,17,32,15,15,0,0,15,2 (2ct 0st),0.4679999999999999,WI,2011,2014
646,CR Ervine,2011-2017,15,26,15,15,0,0,15,4 (4ct 0st),0.5760000000000001,ZIM,2011,2017
647,AG Fairfax,1929-1931,10,19,15,15,0,0,15,3 (3ct 0st),0.789,AUS,1929,1931
648,AD Gaekwad,1974-1985,40,66,15,15,0,0,15,2 (2ct 0st),0.2269999999999999,INDIA,1974,1985
649,G Gunn,1907-1930,15,30,15,15,0,0,15,2 (2ct 0st),0.5,ENG,1907,1930
650,PJ Hughes,2009-2013,26,48,15,15,0,0,15,2 (2ct 0st),0.312,AUS,2009,2013
651,AO Jones,1899-1909,12,23,15,15,0,0,15,2 (2ct 0st),0.652,ENG,1899,1909
652,H Larwood,1926-1933,21,38,15,15,0,0,15,4 (4ct 0st),0.3939999999999999,ENG,1926,1933
653,S Madan Lal,1974-1986,39,66,15,15,0,0,15,1 (1ct 0st),0.2269999999999999,INDIA,1974,1986
654,PNF Mansell,1951-1955,13,24,15,15,0,0,15,2 (2ct 0st),0.625,SA,1951,1955
655,AK Markram,2017-2019,20,39,15,15,0,0,15,3 (3ct 0st),0.384,SA,2017,2019
656,G Millman,1961-1962,6,12,15,13,2,13,0,4 (2ct 2st),1.25,ENG,1961,1962
657,AR Morris,1946-1955,46,90,15,15,0,0,15,2 (2ct 0st),0.166,AUS,1946,1955
658,J Mubarak,2002-2015,13,24,15,15,0,0,15,3 (3ct 0st),0.625,SL,2002,2015
659,WL Murdoch,1877-1892,19,36,15,14,1,3,11,3 (3ct 0st),0.416,AUS/ENG,1877,1892
660,KJ O'Keeffe,1971-1977,24,47,15,15,0,0,15,2 (2ct 0st),0.319,AUS,1971,1977
661,JDP Oram,2002-2009,33,60,15,15,0,0,15,2 (2ct 0st),0.25,NZ,2002,2009
662,DN Patel,1987-1997,37,62,15,15,0,0,15,2 (2ct 0st),0.241,NZ,1987,1997
663,PI Pocock,1968-1985,25,46,15,15,0,0,15,3 (3ct 0st),0.326,ENG,1968,1985
664,MSK Prasad,1999-2000,6,11,15,15,0,15,0,4 (4ct 0st),1.3630000000000002,INDIA,1999,2000
665,Qasim Umar,1983-1986,26,42,15,15,0,0,15,2 (2ct 0st),0.357,PAK,1983,1986
666,Rajin Saleh,2003-2008,24,37,15,15,0,1,14,3 (3ct 0st),0.405,BDESH,2003,2008
667,PR Reiffel,1992-1998,35,68,15,15,0,0,15,1 (1ct 0st),0.22,AUS,1992,1998
668,CJL Rogers,2008-2015,25,49,15,15,0,0,15,3 (3ct 0st),0.306,AUS,2008,2015
669,Saqlain Mushtaq,1995-2004,49,87,15,15,0,0,15,2 (2ct 0st),0.172,PAK,1995,2004
670,PA Strang,1994-2001,24,44,15,15,0,0,15,3 (3ct 0st),0.34,ZIM,1994,2001
671,Taijul Islam,2014-2019,27,47,15,15,0,0,15,2 (2ct 0st),0.319,BDESH,2014,2019
672,DR Tuffey,2000-2010,26,46,15,15,0,0,15,2 (2ct 0st),0.326,NZ,2000,2010
673,A Turner,1975-1977,14,27,15,15,0,0,15,4 (4ct 0st),0.555,AUS,1975,1977
674,W Voce,1930-1947,27,51,15,15,0,0,15,2 (2ct 0st),0.294,ENG,1930,1947
675,AC Voges,2015-2016,20,37,15,15,0,0,15,3 (3ct 0st),0.405,AUS,2015,2016
676,CB Wishart,1995-2005,27,45,15,15,0,0,15,2 (2ct 0st),0.3329999999999999,ZIM,1995,2005
677,Azhar Mahmood,1997-2001,21,37,14,14,0,0,14,3 (3ct 0st),0.3779999999999999,PAK,1997,2001
678,RG Barlow,1881-1887,17,31,14,14,0,0,14,2 (2ct 0st),0.451,ENG,1881,1887
679,SG Barnes,1938-1948,13,25,14,14,0,0,14,3 (3ct 0st),0.56,AUS,1938,1948
680,CJ Barnett,1933-1948,20,39,14,14,0,0,14,2 (2ct 0st),0.358,ENG,1933,1948
681,SJ Benn,2008-2015,26,45,14,14,0,0,14,2 (2ct 0st),0.311,WI,2008,2015
682,SL Boock,1978-1989,30,54,14,14,0,0,14,2 (2ct 0st),0.259,NZ,1978,1989
683,WA Brown,1934-1948,22,41,14,14,0,0,14,2 (2ct 0st),0.341,AUS,1934,1948
684,CL Cairns,1989-2004,62,110,14,14,0,0,14,2 (2ct 0st),0.127,NZ,1989,2004
685,RL Chase,2016-2019,32,56,14,14,0,0,14,3 (3ct 0st),0.25,WI,2016,2019
686,GJ Cosier,1975-1978,18,34,14,14,0,0,14,2 (2ct 0st),0.411,AUS,1975,1978
687,MD Craig,2014-2016,15,29,14,14,0,0,14,2 (2ct 0st),0.482,NZ,2014,2016
688,PAJ DeFreitas,1986-1995,44,78,14,14,0,0,14,2 (2ct 0st),0.179,ENG,1986,1995
689,C de Grandhomme,2016-2019,21,41,14,14,0,0,14,2 (2ct 0st),0.341,NZ,2016,2019
690,HDPK Dharmasena,1993-2004,31,53,14,14,0,0,14,3 (3ct 0st),0.264,SL,1993,2004
691,SS Dighe,2001-2001,6,11,14,12,2,12,0,3 (3ct 0st),1.272,INDIA,2001,2001
692,RA Duff,1902-1905,22,41,14,14,0,0,14,2 (2ct 0st),0.341,AUS,1902,1905
693,SA Durani,1960-1973,29,53,14,14,0,0,14,3 (3ct 0st),0.264,INDIA,1960,1973
694,BA Edgar,1978-1986,39,72,14,14,0,3,11,3 (3ct 0st),0.1939999999999999,NZ,1978,1986
695,MTG Elliott,1996-2004,21,42,14,14,0,0,14,1 (1ct 0st),0.3329999999999999,AUS,1996,2004
696,PGH Fender,1921-1929,13,23,14,14,0,0,14,2 (2ct 0st),0.608,ENG,1921,1929
697,TR Gripper,1999-2004,20,32,14,14,0,0,14,2 (2ct 0st),0.437,ZIM,1999,2004
698,SP Gupte,1951-1961,36,61,14,14,0,0,14,2 (2ct 0st),0.2289999999999999,INDIA,1951,1961
699,CZ Harris,1992-2002,23,38,14,14,0,0,14,3 (3ct 0st),0.368,NZ,1992,2002
700,GA Headley,1930-1954,22,38,14,14,0,0,14,2 (2ct 0st),0.368,WI,1930,1954
701,CJ Jordan,2014-2015,8,16,14,14,0,0,14,3 (3ct 0st),0.875,ENG,2014,2015
702,BD Julien,1973-1977,24,46,14,14,0,0,14,2 (2ct 0st),0.304,WI,1973,1977
703,M Kaif,2000-2006,13,24,14,14,0,0,14,4 (4ct 0st),0.583,INDIA,2000,2006
704,BR Knight,1961-1969,29,55,14,14,0,0,14,2 (2ct 0st),0.254,ENG,1961,1969
705,BW Luckhurst,1970-1974,21,39,14,14,0,0,14,2 (2ct 0st),0.358,ENG,1970,1974
706,CL McCool,1946-1950,14,27,14,14,0,0,14,1 (1ct 0st),0.518,AUS,1946,1950
707,CC McDonald,1952-1961,47,90,14,14,0,0,14,2 (2ct 0st),0.155,AUS,1952,1961
708,AA Mailey,1920-1926,21,38,14,14,0,0,14,2 (2ct 0st),0.368,AUS,1920,1926
709,CS Martin,2000-2013,71,128,14,14,0,0,14,1 (1ct 0st),0.109,NZ,2000,2013
710,Mohammad Rizwan,2016-2019,5,7,14,14,0,13,1,4 (4ct 0st),2.0,PAK,2016,2019
711,DK Morrison,1987-1997,48,76,14,14,0,0,14,2 (2ct 0st),0.184,NZ,1987,1997
712,R Pilling,1881-1888,8,14,14,10,4,10,0,3 (1ct 2st),1.0,ENG,1881,1888
713,AE Relf,1903-1914,13,25,14,14,0,0,14,2 (2ct 0st),0.56,ENG,1903,1914
714,GM Ritchie,1982-1987,30,48,14,14,0,0,14,2 (2ct 0st),0.291,AUS,1982,1987
715,EAB Rowan,1935-1951,26,43,14,14,0,0,14,2 (2ct 0st),0.325,SA,1935,1951
716,MJ Santner,2015-2019,22,42,14,14,0,0,14,1 (1ct 0st),0.3329999999999999,NZ,2015,2019
717,Tamim Iqbal,2008-2019,58,100,14,14,0,0,14,2 (2ct 0st),0.14,BDESH,2008,2019
718,CB van Ryneveld,1951-1958,19,35,14,14,0,0,14,2 (2ct 0st),0.4,SA,1951,1958
719,SM Warnapura,2007-2009,14,26,14,14,0,0,14,2 (2ct 0st),0.5379999999999999,SL,2007,2009
720,C White,1994-2002,30,53,14,14,0,0,14,3 (3ct 0st),0.264,ENG,1994,2002
721,NWD Yardley,1938-1950,20,36,14,14,0,0,14,2 (2ct 0st),0.3879999999999999,ENG,1938,1950
722,R Abel,1888-1902,13,26,13,13,0,0,13,3 (3ct 0st),0.5,ENG,1888,1902
723,L Amarnath,1933-1952,24,38,13,13,0,5,8,3 (3ct 0st),0.342,INDIA,1933,1952
724,J Arun Lal,1982-1989,16,30,13,13,0,0,13,2 (2ct 0st),0.433,INDIA,1982,1989
725,CWJ Athey,1980-1988,23,38,13,13,0,0,13,2 (2ct 0st),0.342,ENG,1980,1988
726,DL Bairstow,1979-1981,4,7,13,12,1,12,0,4 (4ct 0st),1.857,ENG,1979,1981
727,AB Barath,2009-2012,15,27,13,13,0,0,13,3 (3ct 0st),0.481,WI,2009,2012
728,AM Blignaut,2001-2005,19,31,13,13,0,0,13,3 (3ct 0st),0.419,ZIM,2001,2005
729,RJ Bright,1977-1986,25,42,13,13,0,0,13,1 (1ct 0st),0.309,AUS,1977,1986
730,HD Bromfield,1961-1965,9,18,13,13,0,0,13,2 (2ct 0st),0.722,SA,1961,1965
731,MC Carew,1963-1972,19,35,13,13,0,0,13,3 (3ct 0st),0.371,WI,1963,1972
732,JE Cheetham,1949-1955,24,43,13,13,0,0,13,3 (3ct 0st),0.302,SA,1949,1955
733,HL Collins,1920-1926,19,35,13,13,0,0,13,2 (2ct 0st),0.371,AUS,1920,1926
734,JN Crawford,1906-1908,12,23,13,13,0,0,13,3 (3ct 0st),0.565,ENG,1906,1908
735,D Dasgupta,2001-2002,8,15,13,13,0,13,0,3 (3ct 0st),0.866,INDIA,2001,2002
736,JHW Fingleton,1932-1938,18,33,13,13,0,0,13,2 (2ct 0st),0.3929999999999999,AUS,1932,1938
737,RE Foster,1903-1907,8,16,13,13,0,0,13,2 (2ct 0st),0.812,ENG,1903,1907
738,G Geary,1924-1934,14,24,13,13,0,0,13,2 (2ct 0st),0.541,ENG,1924,1934
739,HM Goonatilleke,1982-1982,5,9,13,10,3,10,0,4 (3ct 1st),1.444,SL,1982,1982
740,D Gough,1994-2003,58,99,13,13,0,0,13,2 (2ct 0st),0.131,ENG,1994,2003
741,RS Grant,1935-1939,7,14,13,13,0,0,13,3 (3ct 0st),0.928,WI,1935,1939
742,RJ Harris,2010-2015,27,52,13,13,0,0,13,2 (2ct 0st),0.25,AUS,2010,2015
743,JW Hearne,1911-1926,24,42,13,13,0,0,13,2 (2ct 0st),0.309,ENG,1911,1926
744,AMJ Hilditch,1979-1985,18,28,13,13,0,0,13,2 (2ct 0st),0.4639999999999999,AUS,1979,1985
745,AF Kippax,1925-1934,22,43,13,13,0,0,13,1 (1ct 0st),0.302,AUS,1925,1934
746,M Labuschagne,2018-2019,13,25,13,13,0,0,13,3 (3ct 0st),0.52,AUS,2018,2019
747,M Leyland,1928-1938,41,75,13,13,0,0,13,2 (2ct 0st),0.173,ENG,1928,1938
748,AR MacGibbon,1951-1958,26,38,13,13,0,0,13,2 (2ct 0st),0.342,NZ,1951,1958
749,Maqsood Ahmed,1952-1955,16,27,13,13,0,0,13,2 (2ct 0st),0.481,PAK,1952,1955
750,DPB Morkel,1927-1932,16,28,13,13,0,0,13,2 (2ct 0st),0.4639999999999999,SA,1927,1932
751,DJ Nash,1992-2001,32,56,13,13,0,0,13,2 (2ct 0st),0.2319999999999999,NZ,1992,2001
752,GE Palmer,1880-1886,17,30,13,13,0,0,13,2 (2ct 0st),0.433,AUS,1880,1886
753,JS Patel,2006-2017,24,43,13,13,0,0,13,3 (3ct 0st),0.302,NZ,2006,2017
754,KS Ranjitsinhji,1896-1902,15,26,13,13,0,0,13,2 (2ct 0st),0.5,ENG,1896,1902
755,A Ratra,2002-2002,6,11,13,11,2,11,0,3 (2ct 1st),1.181,INDIA,2002,2002
756,GJ Rennie,1997-2002,23,37,13,13,0,0,13,1 (1ct 0st),0.351,ZIM,1997,2002
757,KAJ Roach,2009-2019,56,101,13,13,0,0,13,2 (2ct 0st),0.128,WI,2009,2019
758,Saeed Ahmed,1958-1973,41,70,13,13,0,0,13,2 (2ct 0st),0.185,PAK,1958,1973
759,CS Serjeant,1977-1978,12,22,13,13,0,0,13,3 (3ct 0st),0.59,AUS,1977,1978
760,JS Solomon,1958-1965,27,53,13,13,0,0,13,2 (2ct 0st),0.245,WI,1958,1965
761,AL Valentine,1950-1962,36,70,13,13,0,0,13,1 (1ct 0st),0.185,WI,1950,1962
762,DJ Vilas,2015-2016,6,10,13,13,0,13,0,4 (4ct 0st),1.3,SA,2015,2016
763,DF Whatmore,1979-1979,7,11,13,13,0,0,13,4 (4ct 0st),1.181,AUS,1979,1979
764,CR Woakes,2013-2019,32,61,13,13,0,0,13,2 (2ct 0st),0.213,ENG,2013,2019
765,J Worrall,1885-1899,11,19,13,13,0,0,13,3 (3ct 0st),0.684,AUS,1885,1899
766,TJE Andrews,1921-1926,16,28,12,12,0,0,12,2 (2ct 0st),0.428,AUS,1921,1926
767,W Bardsley,1909-1926,41,74,12,12,0,0,12,1 (1ct 0st),0.162,AUS,1909,1926
768,SF Barnes,1901-1914,27,52,12,12,0,0,12,2 (2ct 0st),0.23,ENG,1901,1914
769,WKM Benjamin,1987-1995,21,38,12,12,0,0,12,2 (2ct 0st),0.315,WI,1987,1995
770,J Briggs,1884-1899,33,63,12,12,0,0,12,2 (2ct 0st),0.19,ENG,1884,1899
771,G Brown,1921-1923,7,12,12,9,3,9,0,3 (1ct 2st),1.0,ENG,1921,1923
772,W Bruce,1885-1895,14,24,12,12,0,0,12,3 (3ct 0st),0.5,AUS,1885,1895
773,RJ Burns,2018-2019,15,29,12,12,0,0,12,2 (2ct 0st),0.413,ENG,2018,2019
774,RH Catterall,1922-1931,24,41,12,12,0,0,12,3 (3ct 0st),0.292,SA,1922,1931
775,RK Chauhan,1993-1998,21,36,12,12,0,0,12,2 (2ct 0st),0.3329999999999999,INDIA,1993,1998
776,AG Cremer,2005-2017,19,29,12,12,0,0,12,2 (2ct 0st),0.413,ZIM,2005,2017
777,PJ Cummins,2011-2019,29,55,12,12,0,0,12,2 (2ct 0st),0.218,AUS,2011,2019
778,MH Dekker,1993-1996,14,25,12,12,0,0,12,4 (4ct 0st),0.48,ZIM,1993,1996
779,BT Foakes,2018-2019,5,10,12,10,2,10,0,3 (3ct 0st),1.2,ENG,2018,2019
780,JEC Franklin,2001-2013,31,56,12,12,0,0,12,1 (1ct 0st),0.214,NZ,2001,2013
781,GM Fullerton,1947-1951,7,13,12,10,2,6,4,4 (3ct 1st),0.923,SA,1947,1951
782,EA Halliwell,1892-1902,8,13,12,10,2,10,0,2 (2ct 0st),0.923,SA,1892,1902
783,DW Hookes,1977-1985,23,42,12,12,0,0,12,2 (2ct 0st),0.285,AUS,1977,1985
784,WP Howell,1898-1904,18,33,12,12,0,0,12,2 (2ct 0st),0.363,AUS,1898,1904
785,NC Johnson,1998-2000,13,21,12,12,0,0,12,3 (3ct 0st),0.5710000000000001,ZIM,1998,2000
786,SP Jones,1882-1888,12,21,12,12,0,0,12,2 (2ct 0st),0.5710000000000001,AUS,1882,1888
787,JC Laker,1948-1959,46,91,12,12,0,0,12,1 (1ct 0st),0.131,ENG,1948,1959
788,AV Mankad,1969-1978,22,43,12,12,0,0,12,2 (2ct 0st),0.2789999999999999,INDIA,1969,1978
789,RW Morgan,1965-1972,20,37,12,12,0,0,12,2 (2ct 0st),0.324,NZ,1965,1972
790,JDS Neesham,2014-2017,12,24,12,12,0,0,12,3 (3ct 0st),0.5,NZ,2014,2017
791,AD Nourse,1935-1951,34,57,12,12,0,0,12,2 (2ct 0st),0.21,SA,1935,1951
792,SM Patil,1980-1984,29,49,12,12,0,0,12,2 (2ct 0st),0.244,INDIA,1980,1984
793,V Rathour,1996-1997,6,11,12,12,0,0,12,2 (2ct 0st),1.09,INDIA,1996,1997
794,RWV Robins,1929-1937,19,38,12,12,0,0,12,3 (3ct 0st),0.315,ENG,1929,1937
795,JD Ryder,2008-2011,18,32,12,12,0,0,12,2 (2ct 0st),0.375,NZ,2008,2011
796,Salman Butt,2003-2010,33,63,12,12,0,0,12,2 (2ct 0st),0.19,PAK,2003,2010
797,Rev.DS Sheppard,1950-1963,22,42,12,12,0,0,12,1 (1ct 0st),0.285,ENG,1950,1963
798,Shoaib Akhtar,1997-2007,46,86,12,12,0,0,12,2 (2ct 0st),0.139,PAK,1997,2007
799,RT Spooner,1951-1955,7,12,12,10,2,10,0,3 (2ct 1st),1.0,ENG,1951,1955
800,PCR Tufnell,1990-2001,42,74,12,12,0,0,12,1 (1ct 0st),0.162,ENG,1990,2001
801,Umar Akmal,2009-2011,16,31,12,12,0,0,12,2 (2ct 0st),0.387,PAK,2009,2011
802,MRJ Veletta,1987-1990,8,14,12,12,0,0,12,2 (2ct 0st),0.857,AUS,1987,1990
803,N Wagner,2012-2019,46,87,12,12,0,0,12,1 (1ct 0st),0.1369999999999999,NZ,2012,2019
804,MHN Walker,1972-1977,34,64,12,12,0,0,12,1 (1ct 0st),0.187,AUS,1972,1977
805,JH Wardle,1948-1957,28,56,12,12,0,0,12,3 (3ct 0st),0.214,ENG,1948,1957
806,C Washbrook,1937-1956,37,69,12,12,0,0,12,2 (2ct 0st),0.173,ENG,1937,1956
807,JC Watkins,1949-1957,15,28,12,12,0,0,12,3 (3ct 0st),0.428,SA,1949,1957
808,BW Yuile,1963-1969,17,29,12,12,0,0,12,2 (2ct 0st),0.413,NZ,1963,1969
809,DS Atkinson,1948-1958,22,43,11,11,0,0,11,2 (2ct 0st),0.255,WI,1948,1958
810,AM Bacher,1996-1999,19,35,11,11,0,0,11,2 (2ct 0st),0.314,SA,1996,1999
811,RMH Binny,1979-1987,27,47,11,11,0,0,11,1 (1ct 0st),0.2339999999999999,INDIA,1979,1987
812,JH Board,1899-1906,6,11,11,8,3,8,0,2 (2ct 0st),1.0,ENG,1899,1906
813,TB de Bruyn,2017-2019,12,21,11,11,0,0,11,4 (4ct 0st),0.523,SA,2017,2019
814,CC Depeiaza,1955-1956,5,9,11,7,4,6,1,3 (1ct 2st),1.222,WI,1955,1956
815,PS de Villiers,1993-1998,18,35,11,11,0,0,11,2 (2ct 0st),0.314,SA,1993,1998
816,Harry Elliott,1928-1934,4,8,11,8,3,8,0,3 (3ct 0st),1.375,ENG,1928,1934
817,Fazal Mahmood,1952-1962,34,56,11,11,0,0,11,1 (1ct 0st),0.196,PAK,1952,1962
818,W Ferguson,1948-1954,8,16,11,11,0,0,11,3 (3ct 0st),0.687,WI,1948,1954
819,FR Foster,1911-1912,11,20,11,11,0,0,11,2 (2ct 0st),0.55,ENG,1911,1912
820,Ghulam Ahmed,1948-1959,22,37,11,11,0,0,11,1 (1ct 0st),0.297,INDIA,1948,1959
821,WW Hall,1958-1969,48,92,11,11,0,0,11,1 (1ct 0st),0.119,WI,1958,1969
822,Hanumant Singh,1964-1969,14,25,11,11,0,0,11,2 (2ct 0st),0.44,INDIA,1964,1969
823,RI Harford,1968-1968,3,6,11,11,0,11,0,5 (5ct 0st),1.833,NZ,1968,1968
824,VS Hazare,1946-1953,30,48,11,11,0,0,11,2 (2ct 0st),0.2289999999999999,INDIA,1946,1953
825,AJY Hopkins,1902-1909,20,38,11,11,0,0,11,2 (2ct 0st),0.289,AUS,1902,1909
826,J Hunter,1884-1885,5,10,11,8,3,8,0,4 (2ct 2st),1.1,ENG,1884,1885
827,GL Jessop,1899-1912,18,34,11,11,0,0,11,2 (2ct 0st),0.3229999999999999,ENG,1899,1912
828,Junaid Siddique,2008-2012,19,33,11,11,0,0,11,2 (2ct 0st),0.3329999999999999,BDESH,2008,2012
829,RWT Key,2002-2005,15,27,11,11,0,0,11,2 (2ct 0st),0.407,ENG,2002,2005
830,DS Lehmann,1998-2004,27,54,11,11,0,0,11,1 (1ct 0st),0.203,AUS,1998,2004
831,JK Lever,1976-1986,21,38,11,11,0,0,11,1 (1ct 0st),0.289,ENG,1976,1986
832,P Lever,1970-1975,17,31,11,11,0,0,11,2 (2ct 0st),0.354,ENG,1970,1975
833,D Lloyd,1974-1975,9,18,11,11,0,0,11,3 (3ct 0st),0.611,ENG,1974,1975
834,DJ Malan,2017-2018,15,27,11,11,0,0,11,2 (2ct 0st),0.407,ENG,2017,2018
835,EJG Morgan,2010-2012,16,32,11,11,0,0,11,2 (2ct 0st),0.3429999999999999,ENG,2010,2012
836,BA Murphy,2000-2001,11,20,11,11,0,0,11,1 (1ct 0st),0.55,ZIM,2000,2001
837,Nasim-ul-Ghani,1958-1973,29,49,11,11,0,0,11,2 (2ct 0st),0.2239999999999999,PAK,1958,1973
838,MS Nichols,1930-1939,14,24,11,11,0,0,11,2 (2ct 0st),0.4579999999999999,ENG,1930,1939
839,MHW Papps,2004-2007,8,14,11,11,0,0,11,2 (2ct 0st),0.785,NZ,2004,2007
840,H Philipson,1892-1895,5,9,11,8,3,8,0,3 (1ct 2st),1.222,ENG,1892,1895
841,B Reddy,1979-1979,4,5,11,9,2,9,0,3 (3ct 0st),2.2,INDIA,1979,1979
842,Rubel Hossain,2009-2018,26,46,11,11,0,0,11,1 (1ct 0st),0.239,BDESH,2009,2018
843,HD Rutherford,2013-2015,16,31,11,11,0,0,11,3 (3ct 0st),0.354,NZ,2013,2015
844,Saeed Ajmal,2009-2014,35,67,11,11,0,0,11,2 (2ct 0st),0.1639999999999999,PAK,2009,2014
845,Saleem Elahi,1995-2003,13,23,11,10,1,0,10,4 (4ct 0st),0.478,PAK,1995,2003
846,Shadab Kabir,1996-2002,5,9,11,11,0,0,11,3 (3ct 0st),1.222,PAK,1996,2002
847,Shan Masood,2013-2019,19,33,11,11,0,0,11,2 (2ct 0st),0.3329999999999999,PAK,2013,2019
848,IS Sodhi,2013-2018,17,33,11,11,0,0,11,2 (2ct 0st),0.3329999999999999,NZ,2013,2018
849,FR Spofforth,1877-1887,18,31,11,11,0,0,11,3 (3ct 0st),0.354,AUS,1877,1887
850,W Storer,1897-1899,6,10,11,11,0,11,0,3 (3ct 0st),1.1,ENG,1897,1899
851,BC Strang,1995-2001,26,46,11,11,0,0,11,1 (1ct 0st),0.239,ZIM,1995,2001
852,MW Tate,1924-1935,39,68,11,11,0,0,11,2 (2ct 0st),0.161,ENG,1924,1935
853,JM Taylor,1920-1926,20,37,11,11,0,0,11,1 (1ct 0st),0.297,AUS,1920,1926
854,Umar Gul,2003-2013,47,91,11,11,0,0,11,2 (2ct 0st),0.12,PAK,2003,2013
855,PL van der Merwe,1963-1967,15,30,11,11,0,0,11,2 (2ct 0st),0.366,SA,1963,1967
856,M van Jaarsveld,2002-2004,9,17,11,11,0,0,11,2 (2ct 0st),0.647,SA,2002,2004
857,S Viswanath,1985-1985,3,6,11,11,0,11,0,4 (4ct 0st),1.833,INDIA,1985,1985
858,TW Wall,1929-1934,18,34,11,11,0,0,11,2 (2ct 0st),0.3229999999999999,AUS,1929,1934
859,PJ Wiseman,1998-2005,25,48,11,11,0,0,11,2 (2ct 0st),0.2289999999999999,NZ,1998,2005
860,A Wood,1938-1939,4,7,11,10,1,10,0,2 (2ct 0st),1.571,ENG,1938,1939
861,Yajurvindra Singh,1977-1979,4,8,11,11,0,0,11,5 (5ct 0st),1.375,INDIA,1977,1979
862,DA Allen,1960-1966,39,69,10,10,0,0,10,2 (2ct 0st),0.144,ENG,1960,1966
863,Al Sahariar,2000-2003,15,20,10,10,0,0,10,3 (3ct 0st),0.5,BDESH,2000,2003
864,Asim Kamal,2003-2005,12,23,10,10,0,0,10,2 (2ct 0st),0.434,PAK,2003,2005
865,A Bacher,1965-1970,12,24,10,10,0,0,10,2 (2ct 0st),0.416,SA,1965,1970
866,GJ Bailey,2013-2014,5,10,10,10,0,0,10,2 (2ct 0st),1.0,AUS,2013,2014
867,KC Bland,1961-1966,21,40,10,10,0,0,10,2 (2ct 0st),0.25,SA,1961,1966
868,HF Boyle,1879-1884,12,23,10,10,0,0,10,1 (1ct 0st),0.434,AUS,1879,1884
869,DAJ Bracewell,2011-2016,27,49,10,10,0,0,10,2 (2ct 0st),0.204,NZ,2011,2016
870,BC Broad,1984-1989,25,41,10,10,0,0,10,2 (2ct 0st),0.243,ENG,1984,1989
871,ME Chapple,1953-1966,14,26,10,10,0,0,10,2 (2ct 0st),0.384,NZ,1953,1966
872,RO Collinge,1965-1978,35,63,10,10,0,0,10,1 (1ct 0st),0.158,NZ,1965,1978
873,RDB Croft,1996-2001,21,35,10,10,0,0,10,2 (2ct 0st),0.285,ENG,1996,2001
874,WW Davis,1983-1988,15,28,10,10,0,0,10,2 (2ct 0st),0.357,WI,1983,1988
875,OC Dawson,1947-1949,9,17,10,10,0,0,10,3 (3ct 0st),0.588,SA,1947,1949
876,GR Dilley,1979-1989,41,66,10,10,0,0,10,2 (2ct 0st),0.151,ENG,1979,1989
877,DR Doshi,1979-1983,33,57,10,10,0,0,10,2 (2ct 0st),0.175,INDIA,1979,1983
878,KS Duleepsinhji,1929-1931,12,17,10,10,0,0,10,2 (2ct 0st),0.588,ENG,1929,1931
879,J Dyson,1977-1984,30,56,10,10,0,0,10,2 (2ct 0st),0.178,AUS,1977,1984
880,FH Edwards,2003-2012,55,102,10,10,0,0,10,1 (1ct 0st),0.098,WI,2003,2012
881,CRD Fernando,2000-2012,40,69,10,10,0,0,10,2 (2ct 0st),0.144,SL,2000,2012
882,DR Flynn,2008-2013,24,40,10,10,0,0,10,2 (2ct 0st),0.25,NZ,2008,2013
883,G Fowler,1982-1985,21,39,10,10,0,0,10,1 (1ct 0st),0.256,ENG,1982,1985
884,MW Goodwin,1998-2000,19,32,10,10,0,0,10,3 (3ct 0st),0.312,ZIM,1998,2000
885,GC Grant,1930-1935,12,18,10,10,0,0,10,2 (2ct 0st),0.555,WI,1930,1935
886,RE Grieveson,1939-1939,2,4,10,7,3,7,0,3 (3ct 0st),2.5,SA,1939,1939
887,Haris Sohail,2017-2019,13,23,10,10,0,0,10,2 (2ct 0st),0.434,PAK,2017,2019
888,TM Head,2018-2019,16,31,10,10,0,0,10,2 (2ct 0st),0.322,AUS,2018,2019
889,HSTL Hendry,1921-1929,11,22,10,10,0,0,10,3 (3ct 0st),0.4539999999999999,AUS,1921,1929
890,Hon.FS Jackson,1893-1905,20,36,10,10,0,0,10,2 (2ct 0st),0.2769999999999999,ENG,1893,1905
891,Javed Omar,2001-2007,40,54,10,10,0,0,10,2 (2ct 0st),0.185,BDESH,2001,2007
892,DRE Joseph,1999-1999,4,8,10,10,0,0,10,3 (3ct 0st),1.25,WI,1999,1999
893,RS Kalpage,1993-1999,11,16,10,10,0,0,10,2 (2ct 0st),0.625,SL,1993,1999
894,GF Lawson,1980-1989,46,81,10,10,0,0,10,2 (2ct 0st),0.123,AUS,1980,1989
895,PA McAlister,1904-1909,8,16,10,10,0,0,10,2 (2ct 0st),0.625,AUS,1904,1909
896,TG McIntosh,2008-2011,17,32,10,10,0,0,10,2 (2ct 0st),0.312,NZ,2008,2011
897,CA McWatt,1954-1955,6,11,10,9,1,9,0,3 (3ct 0st),0.909,WI,1954,1955
898,IL Mendonca,1962-1962,2,4,10,8,2,8,0,3 (2ct 1st),2.5,WI,1962,1962
899,WE Midwinter,1877-1887,12,22,10,10,0,0,10,2 (2ct 0st),0.4539999999999999,AUS/ENG,1877,1887
900,Mohammed Shami,2013-2019,47,91,10,10,0,0,10,1 (1ct 0st),0.109,INDIA,2013,2019
901,PJ Moor,2016-2018,8,14,10,9,1,6,3,3 (2ct 1st),0.7140000000000001,ZIM,2016,2018
902,MD Moxon,1986-1989,10,16,10,10,0,0,10,3 (3ct 0st),0.625,ENG,1986,1989
903,Nasir Hossain,2011-2017,19,33,10,10,0,0,10,2 (2ct 0st),0.303,BDESH,2011,2017
904,PP Ojha,2009-2013,24,48,10,10,0,0,10,1 (1ct 0st),0.208,INDIA,2009,2013
905,HK Olonga,1995-2002,30,51,10,10,0,0,10,2 (2ct 0st),0.196,ZIM,1995,2002
906,MS Panesar,2006-2013,50,90,10,10,0,0,10,1 (1ct 0st),0.111,ENG,2006,2013
907,DR Pringle,1982-1992,30,56,10,10,0,0,10,2 (2ct 0st),0.178,ENG,1982,1992
908,KR Pushpakumara,1994-2001,23,39,10,10,0,0,10,3 (3ct 0st),0.256,SL,1994,2001
909,AF Rae,1948-1953,15,30,10,10,0,0,10,2 (2ct 0st),0.3329999999999999,WI,1948,1953
910,VS Ransford,1907-1912,20,39,10,10,0,0,10,2 (2ct 0st),0.256,AUS,1907,1912
911,Shahid Afridi,1998-2010,27,52,10,10,0,0,10,2 (2ct 0st),0.192,PAK,1998,2010
912,BR Taylor,1965-1973,30,55,10,10,0,0,10,1 (1ct 0st),0.181,NZ,1965,1973
913,PL Taylor,1987-1991,13,23,10,10,0,0,10,2 (2ct 0st),0.434,AUS,1987,1991
914,EFS Tylecote,1882-1886,6,12,10,5,5,5,0,3 (1ct 2st),0.833,ENG,1882,1886
915,KDK Vithanage,2013-2015,10,20,10,10,0,0,10,2 (2ct 0st),0.5,SL,2013,2015
916,MN Waller,2011-2017,14,25,10,10,0,0,10,2 (2ct 0st),0.4,ZIM,2011,2017
917,CAK Walton,2009-2009,2,4,10,10,0,10,0,5 (5ct 0st),2.5,WI,2009,2009
918,Waqar Hasan,1952-1959,21,36,10,10,0,0,10,2 (2ct 0st),0.2769999999999999,PAK,1952,1959
919,S Wettimuny,1982-1987,23,35,10,10,0,0,10,2 (2ct 0st),0.285,SL,1982,1987
920,GC White,1906-1912,17,31,10,10,0,0,10,2 (2ct 0st),0.322,SA,1906,1912
921,AGD Wickremasinghe,1989-1992,3,6,10,9,1,9,0,3 (3ct 0st),1.666,SL,1989,1992
922,RA Woolmer,1975-1981,19,36,10,10,0,0,10,2 (2ct 0st),0.2769999999999999,ENG,1975,1981
923,DVP Wright,1938-1951,34,62,10,10,0,0,10,2 (2ct 0st),0.161,ENG,1938,1951
924,NS Yadav,1979-1987,35,64,10,10,0,0,10,1 (1ct 0st),0.156,INDIA,1979,1987
925,Zulqarnain,1986-1986,3,6,10,8,2,8,0,3 (3ct 0st),1.666,PAK,1986,1986
926,PK Amre,1992-1993,11,21,9,9,0,0,9,2 (2ct 0st),0.428,INDIA,1992,1993
927,GG Arnold,1967-1975,34,61,9,9,0,0,9,2 (2ct 0st),0.147,ENG,1967,1975
928,W Attewell,1884-1892,10,20,9,9,0,0,9,2 (2ct 0st),0.45,ENG,1884,1892
929,W Bates,1881-1887,15,29,9,9,0,0,9,1 (1ct 0st),0.31,ENG,1881,1887
930,JM Blanckenberg,1913-1924,18,29,9,9,0,0,9,2 (2ct 0st),0.31,SA,1913,1924
931,BJT Bosanquet,1903-1905,7,13,9,9,0,0,9,2 (2ct 0st),0.6920000000000001,ENG,1903,1905
932,G Cook,1982-1983,7,13,9,9,0,0,9,2 (2ct 0st),0.6920000000000001,ENG,1982,1983
933,NG Cowans,1982-1985,19,36,9,9,0,0,9,1 (1ct 0st),0.25,ENG,1982,1985
934,IC Davis,1973-1977,15,28,9,9,0,0,9,2 (2ct 0st),0.321,AUS,1973,1977
935,ALF de Mel,1982-1986,17,27,9,9,0,0,9,2 (2ct 0st),0.3329999999999999,SL,1982,1986
936,RB Desai,1959-1968,28,45,9,9,0,0,9,2 (2ct 0st),0.2,INDIA,1959,1968
937,JWHT Douglas,1911-1925,23,42,9,9,0,0,9,3 (3ct 0st),0.214,ENG,1911,1925
938,T Emmett,1877-1882,7,13,9,9,0,0,9,3 (3ct 0st),0.6920000000000001,ENG,1877,1882
939,LE Favell,1954-1961,19,37,9,9,0,0,9,2 (2ct 0st),0.243,AUS,1954,1961
940,DW Fleming,1994-2001,20,38,9,9,0,0,9,2 (2ct 0st),0.236,AUS,1994,2001
941,ARC Fraser,1989-1998,46,80,9,9,0,0,9,2 (2ct 0st),0.1119999999999999,ENG,1989,1998
942,JH Hampshire,1969-1975,8,16,9,9,0,0,9,2 (2ct 0st),0.562,ENG,1969,1975
943,J Hardstaff jnr,1935-1948,23,44,9,9,0,0,9,1 (1ct 0st),0.204,ENG,1935,1948
944,MN Hart,1994-1995,14,22,9,9,0,0,9,1 (1ct 0st),0.409,NZ,1994,1995
945,NJN Hawke,1963-1968,27,50,9,9,0,0,9,1 (1ct 0st),0.18,AUS,1963,1968
946,BJ Hodge,2005-2008,6,12,9,9,0,0,9,2 (2ct 0st),0.75,AUS,2005,2008
947,RIC Holder,1997-1999,11,19,9,9,0,0,9,2 (2ct 0st),0.473,WI,1997,1999
948,GJ Hopkins,2008-2010,4,6,9,9,0,9,0,3 (3ct 0st),1.5,NZ,2008,2010
949,KL Hutchings,1907-1909,7,14,9,9,0,0,9,2 (2ct 0st),0.642,ENG,1907,1909
950,RA Hutton,1971-1971,5,9,9,9,0,0,9,2 (2ct 0st),1.0,ENG,1971,1971
951,KS Indrajitsinhji,1964-1969,4,8,9,6,3,6,0,2 (2ct 0st),1.125,INDIA,1964,1969
952,HJ Keith,1953-1957,8,16,9,9,0,0,9,2 (2ct 0st),0.562,SA,1953,1957
953,LF Kline,1957-1961,13,25,9,9,0,0,9,2 (2ct 0st),0.36,AUS,1957,1961
954,RA Legall,1953-1953,4,8,9,8,1,8,0,3 (3ct 0st),1.125,WI,1953,1953
955,SN McGregor,1955-1965,25,39,9,9,0,0,9,1 (1ct 0st),0.23,NZ,1955,1965
956,CE McLeod,1894-1905,17,31,9,9,0,0,9,1 (1ct 0st),0.29,AUS,1894,1905
957,RS Madugalle,1982-1988,21,34,9,9,0,0,9,2 (2ct 0st),0.264,SL,1982,1988
958,Maninder Singh,1982-1993,35,57,9,9,0,0,9,1 (1ct 0st),0.157,INDIA,1982,1993
959,Mansoor Akhtar,1980-1990,19,34,9,9,0,0,9,1 (1ct 0st),0.264,PAK,1980,1990
960,MK Mantri,1951-1955,4,8,9,8,1,6,2,4 (3ct 1st),1.125,INDIA,1951,1955
961,Mashrafe Mortaza,2001-2009,36,52,9,9,0,0,9,1 (1ct 0st),0.173,BDESH,2001,2009
962,I Meckiff,1957-1963,18,36,9,9,0,0,9,2 (2ct 0st),0.25,AUS,1957,1963
963,LRD Mendis,1982-1988,24,37,9,9,0,0,9,1 (1ct 0st),0.243,SL,1982,1988
964,A Mitchell,1933-1936,6,12,9,9,0,0,9,2 (2ct 0st),0.75,ENG,1933,1936
965,TM Moody,1989-1992,8,13,9,9,0,0,9,2 (2ct 0st),0.6920000000000001,AUS,1989,1992
966,JFM Morrison,1973-1982,17,29,9,9,0,0,9,2 (2ct 0st),0.31,NZ,1973,1982
967,RC Motz,1961-1969,32,58,9,9,0,0,9,1 (1ct 0st),0.155,NZ,1961,1969
968,Naushad Ali,1965-1965,6,11,9,9,0,9,0,3 (3ct 0st),0.818,PAK,1965,1965
969,EP Nupen,1921-1936,17,32,9,9,0,0,9,2 (2ct 0st),0.281,SA,1921,1936
970,Pervez Sajjad,1964-1973,19,37,9,9,0,0,9,1 (1ct 0st),0.243,PAK,1964,1973
971,RJ Peterson,2003-2014,15,29,9,9,0,0,9,2 (2ct 0st),0.31,SA,2003,2014
972,PM Pollock,1961-1970,28,54,9,9,0,0,9,2 (2ct 0st),0.166,SA,1961,1970
973,Rahat Ali,2013-2018,21,40,9,9,0,0,9,1 (1ct 0st),0.225,PAK,2013,2018
974,S Ramadhin,1950-1961,43,82,9,9,0,0,9,2 (2ct 0st),0.109,WI,1950,1961
975,Raqibul Hasan,2008-2011,9,17,9,9,0,0,9,2 (2ct 0st),0.529,BDESH,2008,2011
976,RJ Ratnayake,1983-1992,23,36,9,9,0,0,9,1 (1ct 0st),0.25,SL,1983,1992
977,JF Reid,1979-1986,19,35,9,9,0,0,9,3 (3ct 0st),0.257,NZ,1979,1986
978,AME Roberts,1974-1983,47,90,9,9,0,0,9,1 (1ct 0st),0.1,WI,1974,1983
979,Shahadat Hossain,2005-2015,38,63,9,9,0,0,9,1 (1ct 0st),0.142,BDESH,2005,2015
980,S Shillingford,2010-2014,16,29,9,9,0,0,9,1 (1ct 0st),0.31,WI,2010,2014
981,NS Sidhu,1983-1999,51,90,9,9,0,0,9,2 (2ct 0st),0.1,INDIA,1983,1999
982,JH Sinclair,1896-1911,25,46,9,9,0,0,9,1 (1ct 0st),0.195,SA,1896,1911
983,L Sivaramakrishnan,1983-1986,9,16,9,9,0,0,9,2 (2ct 0st),0.562,INDIA,1983,1986
984,GC Small,1986-1991,17,32,9,9,0,0,9,2 (2ct 0st),0.281,ENG,1986,1991
985,DR Smith,2004-2006,10,18,9,9,0,0,9,3 (3ct 0st),0.5,WI,2004,2006
986,OG Smith,1955-1959,26,46,9,9,0,0,9,2 (2ct 0st),0.195,WI,1955,1959
987,RT Stanyforth,1927-1928,4,8,9,7,2,7,0,3 (3ct 0st),1.125,ENG,1927,1928
988,GTS Stevens,1922-1930,10,19,9,9,0,0,9,2 (2ct 0st),0.473,ENG,1922,1930
989,V Subramanya,1965-1968,9,15,9,9,0,0,9,3 (3ct 0st),0.6,INDIA,1965,1968
990,Taslim Arif,1980-1980,6,10,9,6,3,6,0,2 (1ct 1st),0.9,PAK,1980,1980
991,Tauseef Ahmed,1980-1993,34,62,9,9,0,0,9,2 (2ct 0st),0.145,PAK,1980,1993
992,PM Toohey,1977-1980,15,28,9,9,0,0,9,2 (2ct 0st),0.321,AUS,1977,1980
993,L Tuckett,1947-1949,9,17,9,9,0,0,9,2 (2ct 0st),0.529,SA,1947,1949
994,PA Wallace,1997-1999,7,13,9,9,0,0,9,2 (2ct 0st),0.6920000000000001,WI,1997,1999
995,SC Williams,2013-2018,10,18,9,9,0,0,9,2 (2ct 0st),0.5,ZIM,2013,2018
996,Abdur Rehman,2007-2014,22,44,8,8,0,0,8,1 (1ct 0st),0.181,PAK,2007,2014
997,HR Adhikari,1947-1959,21,30,8,8,0,0,8,2 (2ct 0st),0.266,INDIA,1947,1959
998,Akram Raza,1989-1995,9,15,8,8,0,0,8,2 (2ct 0st),0.5329999999999999,PAK,1989,1995
999,Alimuddin,1954-1962,25,43,8,8,0,0,8,2 (2ct 0st),0.186,PAK,1954,1962
1000,EG Arnold,1903-1907,10,19,8,8,0,0,8,2 (2ct 0st),0.421,ENG,1903,1907
1001,GA Bartlett,1961-1968,10,18,8,8,0,0,8,1 (1ct 0st),0.444,NZ,1961,1968
1002,CA Best,1986-1990,8,16,8,8,0,0,8,2 (2ct 0st),0.5,WI,1986,1990
1003,MG Bevan,1994-1998,18,36,8,8,0,0,8,2 (2ct 0st),0.222,AUS,1994,1998
1004,JG Binks,1964-1964,2,4,8,8,0,8,0,5 (5ct 0st),2.0,ENG,1964,1964
1005,IR Bishop,1989-1998,43,79,8,8,0,0,8,2 (2ct 0st),0.1009999999999999,WI,1989,1998
1006,SE Bond,2001-2009,18,32,8,8,0,0,8,1 (1ct 0st),0.25,NZ,2001,2009
1007,TT Bresnan,2009-2013,23,43,8,8,0,0,8,1 (1ct 0st),0.186,ENG,2009,2013
1008,T Campbell,1910-1912,5,9,8,7,1,7,0,2 (2ct 0st),0.888,SA,1910,1912
1009,HB Cave,1949-1958,19,27,8,8,0,0,8,2 (2ct 0st),0.296,NZ,1949,1958
1010,BB Chari,2014-2018,7,13,8,8,0,3,5,3 (3ct 0st),0.615,ZIM,2014,2018
1011,WL Cornford,1930-1930,4,6,8,5,3,5,0,3 (2ct 1st),1.3330000000000002,ENG,1930,1930
1012,A Cotter,1904-1912,21,40,8,8,0,0,8,2 (2ct 0st),0.2,AUS,1904,1912
1013,CEH Croft,1977-1982,27,52,8,8,0,0,8,2 (2ct 0st),0.153,WI,1977,1982
1014,LS Darling,1933-1937,12,23,8,8,0,0,8,3 (3ct 0st),0.347,AUS,1933,1937
1015,HG Deane,1924-1931,17,27,8,8,0,0,8,2 (2ct 0st),0.296,SA,1924,1931
1016,D Denton,1905-1910,11,21,8,8,0,0,8,2 (2ct 0st),0.38,ENG,1905,1910
1017,ST Finn,2010-2016,36,68,8,8,0,0,8,2 (2ct 0st),0.1169999999999999,ENG,2010,2016
1018,TJ Franklin,1983-1991,21,35,8,8,0,0,8,2 (2ct 0st),0.228,NZ,1983,1991
1019,N Gifford,1964-1973,15,27,8,8,0,0,8,1 (1ct 0st),0.296,ENG,1964,1973
1020,GJ Gilmour,1973-1977,15,29,8,8,0,0,8,2 (2ct 0st),0.275,AUS,1973,1977
1021,DR Hadlee,1969-1978,26,45,8,8,0,0,8,2 (2ct 0st),0.177,NZ,1969,1978
1022,S Haigh,1899-1912,11,19,8,8,0,0,8,2 (2ct 0st),0.421,ENG,1899,1912
1023,AD Hales,2015-2016,11,21,8,8,0,0,8,2 (2ct 0st),0.38,ENG,2015,2016
1024,WK Hegg,1998-1999,2,4,8,8,0,8,0,3 (3ct 0st),2.0,ENG,1998,1999
1025,PS Heine,1955-1962,14,28,8,8,0,0,8,2 (2ct 0st),0.285,SA,1955,1962
1026,RNS Hobbs,1967-1971,7,12,8,8,0,0,8,2 (2ct 0st),0.6659999999999999,ENG,1967,1971
1027,JKC Holt,1954-1959,17,32,8,8,0,0,8,2 (2ct 0st),0.25,WI,1954,1959
1028,Imran Tahir,2011-2015,20,38,8,8,0,0,8,1 (1ct 0st),0.21,SA,2011,2015
1029,DJ Insole,1950-1957,9,18,8,8,0,0,8,3 (3ct 0st),0.444,ENG,1950,1957
1030,Khurram Manzoor,2009-2014,16,30,8,8,0,0,8,2 (2ct 0st),0.266,PAK,2009,2014
1031,PN Kirsten,1992-1994,12,23,8,8,0,0,8,3 (3ct 0st),0.347,SA,1992,1994
1032,P Krishnamurthy,1971-1971,5,10,8,7,1,7,0,2 (2ct 0st),0.8,INDIA,1971,1971
1033,KMDN Kulasekara,2005-2014,21,40,8,8,0,0,8,2 (2ct 0st),0.2,SL,2005,2014
1034,B Kumar,2013-2018,21,38,8,8,0,0,8,2 (2ct 0st),0.21,INDIA,2013,2018
1035,CB Lambert,1991-1998,5,10,8,8,0,0,8,3 (3ct 0st),0.8,WI,1991,1998
1036,ACB Langton,1935-1939,15,23,8,8,0,0,8,1 (1ct 0st),0.347,SA,1935,1939
1037,W Larkins,1980-1991,13,22,8,8,0,0,8,2 (2ct 0st),0.363,ENG,1980,1991
1038,FJ Laver,1899-1909,15,28,8,8,0,0,8,1 (1ct 0st),0.285,AUS,1899,1909
1039,DM Lewis,1971-1971,3,6,8,8,0,8,0,4 (4ct 0st),1.3330000000000002,WI,1971,1971
1040,TC Lowry,1930-1931,7,11,8,8,0,0,8,2 (2ct 0st),0.727,NZ,1930,1931
1041,A Lyth,2015-2015,7,13,8,8,0,0,8,2 (2ct 0st),0.615,ENG,2015,2015
1042,EL McCormick,1935-1938,12,22,8,8,0,0,8,2 (2ct 0st),0.363,AUS,1935,1938
1043,AJW McIntyre,1950-1955,3,5,8,8,0,7,1,3 (3ct 0st),1.6,ENG,1950,1955
1044,TG McMahon,1955-1956,5,6,8,7,1,7,0,3 (2ct 1st),1.3330000000000002,NZ,1955,1956
1045,Q McMillan,1929-1932,13,23,8,8,0,0,8,2 (2ct 0st),0.347,SA,1929,1932
1046,A Melville,1938-1949,11,20,8,8,0,0,8,2 (2ct 0st),0.4,SA,1938,1949
1047,BD Milburn,1969-1969,3,5,8,6,2,6,0,3 (3ct 0st),1.6,NZ,1969,1969
1048,A Mishra,2008-2016,22,40,8,8,0,0,8,1 (1ct 0st),0.2,INDIA,2008,2016
1049,MV Narasimha Rao,1978-1979,4,8,8,8,0,0,8,2 (2ct 0st),1.0,INDIA,1978,1979
1050,Nurul Hasan,2017-2018,3,5,8,5,3,5,0,3 (0ct 3st),1.6,BDESH,2017,2018
1051,IK Pathan,2003-2008,29,54,8,8,0,0,8,1 (1ct 0st),0.148,INDIA,2003,2008
1052,DBL Powell,2002-2009,37,68,8,8,0,0,8,2 (2ct 0st),0.1169999999999999,WI,2002,2009
1053,D Ramnarine,1998-2002,12,24,8,8,0,0,8,2 (2ct 0st),0.3329999999999999,WI,1998,2002
1054,JM Read,1882-1893,17,33,8,8,0,0,8,1 (1ct 0st),0.242,ENG,1882,1893
1055,MT Renshaw,2016-2018,11,21,8,8,0,0,8,1 (1ct 0st),0.38,AUS,2016,2018
1056,RT Robinson,1984-1989,29,49,8,8,0,0,8,1 (1ct 0st),0.163,ENG,1984,1989
1057,CAG Russell,1920-1923,10,16,8,8,0,0,8,3 (3ct 0st),0.5,ENG,1920,1923
1058,RG Samuels,1996-1997,6,12,8,8,0,0,8,2 (2ct 0st),0.6659999999999999,WI,1996,1997
1059,HJH Scott,1884-1886,8,13,8,8,0,0,8,2 (2ct 0st),0.615,AUS,1884,1886
1060,Shujauddin,1954-1962,19,34,8,8,0,0,8,1 (1ct 0st),0.235,PAK,1954,1962
1061,Shuvagata Hom,2014-2016,8,14,8,8,0,0,8,2 (2ct 0st),0.5710000000000001,BDESH,2014,2016
1062,BW Sinclair,1963-1968,21,37,8,8,0,0,8,2 (2ct 0st),0.216,NZ,1963,1968
1063,GB Studd,1882-1883,4,8,8,8,0,0,8,3 (3ct 0st),1.0,ENG,1882,1883
1064,ML Su'a,1992-1995,13,22,8,8,0,0,8,2 (2ct 0st),0.363,NZ,1992,1995
1065,R Tattersall,1951-1954,16,30,8,8,0,0,8,2 (2ct 0st),0.266,ENG,1951,1954
1066,JE Taylor,2003-2016,46,81,8,8,0,0,8,1 (1ct 0st),0.098,WI,2003,2016
1067,AJ Traicos,1970-1993,7,12,8,8,0,0,8,4 (4ct 0st),0.6659999999999999,SA/ZIM,1970,1993
1068,CTB Turner,1887-1895,17,30,8,8,0,0,8,2 (2ct 0st),0.266,AUS,1887,1895
1069,JM Vince,2016-2018,13,24,8,8,0,0,8,2 (2ct 0st),0.3329999999999999,ENG,2016,2018
1070,W Watson,1951-1959,23,44,8,8,0,0,8,1 (1ct 0st),0.181,ENG,1951,1959
1071,AR Whittall,1996-1999,10,16,8,8,0,0,8,3 (3ct 0st),0.5,ZIM,1996,1999
1072,TS Worthington,1930-1937,9,15,8,8,0,0,8,1 (1ct 0st),0.5329999999999999,ENG,1930,1937
1073,RA Young,2011-2011,5,10,8,8,0,8,0,2 (2ct 0st),0.8,NZ,2011,2011
1074,Aftab Ahmed,2004-2010,16,23,7,7,0,0,7,2 (2ct 0st),0.304,BDESH,2004,2010
1075,MA Agarwal,2018-2019,9,18,7,7,0,0,7,2 (2ct 0st),0.3879999999999999,INDIA,2018,2019
1076,JC Alabaster,1955-1972,21,35,7,7,0,0,7,1 (1ct 0st),0.2,NZ,1955,1972
1077,Inshan Ali,1971-1977,12,23,7,7,0,0,7,2 (2ct 0st),0.304,WI,1971,1977
1078,CJ Anderson,2013-2016,13,25,7,7,0,0,7,2 (2ct 0st),0.28,NZ,2013,2016
1079,WE Astill,1927-1930,9,18,7,7,0,0,7,1 (1ct 0st),0.3879999999999999,ENG,1927,1930
1080,Hon.IFW Bligh,1882-1883,4,8,7,7,0,0,7,2 (2ct 0st),0.875,ENG,1882,1883
1081,DJ Brown,1965-1969,26,46,7,7,0,0,7,2 (2ct 0st),0.152,ENG,1965,1969
1082,JT Brown,1894-1899,8,15,7,7,0,1,6,1 (1ct 0st),0.466,ENG,1894,1899
1083,MA Carberry,2010-2014,6,12,7,7,0,0,7,1 (1ct 0st),0.583,ENG,2010,2014
1084,UDU Chandana,1999-2005,16,30,7,7,0,0,7,1 (1ct 0st),0.233,SL,1999,2005
1085,EJ Chatfield,1975-1989,43,75,7,7,0,0,7,2 (2ct 0st),0.093,NZ,1975,1989
1086,CM Christiani,1935-1935,4,8,7,6,1,6,0,3 (2ct 1st),0.875,WI,1935,1935
1087,PT Collins,1999-2006,32,61,7,7,0,0,7,1 (1ct 0st),0.114,WI,1999,2006
1088,NRD Compton,2012-2016,16,29,7,7,0,0,7,2 (2ct 0st),0.241,ENG,2012,2016
1089,JF Crapp,1948-1949,7,13,7,7,0,0,7,2 (2ct 0st),0.5379999999999999,ENG,1948,1949
1090,Dilawar Hussain,1934-1936,3,6,7,6,1,6,0,3 (3ct 0st),1.166,INDIA,1934,1936
1091,MP Donnelly,1937-1949,7,12,7,7,0,0,7,2 (2ct 0st),0.583,NZ,1937,1949
1092,GN Edwards,1977-1981,8,13,7,7,0,7,0,3 (3ct 0st),0.5379999999999999,NZ,1977,1981
1093,R Edwards,1972-1975,20,39,7,7,0,0,7,2 (2ct 0st),0.179,AUS,1972,1975
1094,SM Ervine,2003-2004,5,6,7,7,0,0,7,2 (2ct 0st),1.166,ZIM,2003,2004
1095,W Farrimond,1931-1935,4,8,7,5,2,5,0,2 (0ct 2st),0.875,ENG,1931,1935
1096,AJ Finch,2018-2018,5,10,7,7,0,0,7,4 (4ct 0st),0.7,AUS,2018,2018
1097,NA Foster,1983-1993,29,50,7,7,0,0,7,1 (1ct 0st),0.14,ENG,1983,1993
1098,GN Francis,1928-1933,10,13,7,7,0,0,7,2 (2ct 0st),0.5379999999999999,WI,1928,1933
1099,KJ Funston,1952-1958,18,34,7,7,0,0,7,2 (2ct 0st),0.205,SA,1952,1958
1100,TW Garrett,1877-1888,19,34,7,7,0,0,7,1 (1ct 0st),0.205,AUS,1877,1888
1101,Hannan Sarkar,2002-2004,17,26,7,7,0,0,7,2 (2ct 0st),0.2689999999999999,BDESH,2002,2004
1102,SJ Harmison,2002-2009,63,115,7,7,0,0,7,1 (1ct 0st),0.06,ENG/ICC,2002,2009
1103,MS Harris,2018-2019,9,17,7,7,0,0,7,2 (2ct 0st),0.411,AUS,2018,2019
1104,UC Hathurusingha,1991-1999,26,44,7,7,0,0,7,1 (1ct 0st),0.159,SL,1991,1999
1105,FC Hayes,1973-1976,9,15,7,7,0,0,7,2 (2ct 0st),0.466,ENG,1973,1976
1106,DW Headley,1997-1999,15,25,7,7,0,0,7,1 (1ct 0st),0.28,ENG,1997,1999
1107,SO Hetmyer,2017-2019,16,29,7,7,0,0,7,2 (2ct 0st),0.241,WI,2017,2019
1108,BW Hilfenhaus,2009-2012,27,50,7,7,0,0,7,2 (2ct 0st),0.14,AUS,2009,2012
1109,RO Hinds,2002-2009,15,27,7,7,0,0,7,2 (2ct 0st),0.259,WI,2002,2009
1110,RM Hogg,1978-1984,38,69,7,7,0,0,7,1 (1ct 0st),0.1009999999999999,AUS,1978,1984
1111,PM Hornibrook,1929-1930,6,11,7,7,0,0,7,2 (2ct 0st),0.636,AUS,1929,1930
1112,J Humphries,1908-1908,3,6,7,7,0,7,0,3 (3ct 0st),1.166,ENG,1908,1908
1113,Imam-ul-Haq,2018-2019,11,20,7,7,0,0,7,4 (4ct 0st),0.35,PAK,2018,2019
1114,A Jackson,1929-1931,8,16,7,7,0,0,7,2 (2ct 0st),0.437,AUS,1929,1931
1115,Jahurul Islam,2010-2013,7,13,7,7,0,0,7,2 (2ct 0st),0.5379999999999999,BDESH,2010,2013
1116,PA Jaques,2005-2008,11,22,7,7,0,0,7,2 (2ct 0st),0.318,AUS,2005,2008
1117,Javed Burki,1960-1969,25,42,7,7,0,0,7,2 (2ct 0st),0.166,PAK,1960,1969
1118,LR Johnson,2014-2016,9,14,7,7,0,0,7,2 (2ct 0st),0.5,WI,2014,2016
1119,SB Joshi,1996-2000,15,28,7,7,0,0,7,1 (1ct 0st),0.25,INDIA,1996,2000
1120,VG Kambli,1993-1995,17,30,7,7,0,0,7,1 (1ct 0st),0.233,INDIA,1993,1995
1121,HR Lance,1962-1970,13,26,7,7,0,0,7,2 (2ct 0st),0.2689999999999999,SA,1962,1970
1122,CB Llewellyn,1896-1912,15,26,7,7,0,0,7,2 (2ct 0st),0.2689999999999999,SA,1896,1912
1123,ML Love,2002-2003,5,10,7,7,0,0,7,3 (3ct 0st),0.7,AUS,2002,2003
1124,SJE Loxton,1948-1951,12,23,7,7,0,0,7,4 (4ct 0st),0.304,AUS,1948,1951
1125,KA Maharaj,2016-2019,28,53,7,7,0,0,7,1 (1ct 0st),0.132,SA,2016,2019
1126,MF Maharoof,2004-2011,22,40,7,7,0,0,7,1 (1ct 0st),0.175,SL,2004,2011
1127,DE Malcolm,1989-1997,40,73,7,7,0,0,7,1 (1ct 0st),0.095,ENG,1989,1997
1128,SL Malinga,2004-2010,30,59,7,7,0,0,7,2 (2ct 0st),0.118,SL,2004,2010
1129,Manzoor Elahi,1984-1995,6,10,7,7,0,0,7,2 (2ct 0st),0.7,PAK,1984,1995
1130,XM Marshall,2005-2009,7,14,7,7,0,0,7,2 (2ct 0st),0.5,WI,2005,2009
1131,S Matsikenyeri,2003-2005,8,12,7,7,0,0,7,2 (2ct 0st),0.583,ZIM,2003,2005
1132,TJ Matthews,1912-1912,8,12,7,7,0,0,7,2 (2ct 0st),0.583,AUS,1912,1912
1133,TMK Mawoyo,2011-2016,11,20,7,7,0,0,7,2 (2ct 0st),0.35,ZIM,2011,2016
1134,VM Merchant,1933-1951,10,18,7,7,0,0,7,2 (2ct 0st),0.3879999999999999,INDIA,1933,1951
1135,C Milburn,1966-1969,9,14,7,7,0,0,7,2 (2ct 0st),0.5,ENG,1966,1969
1136,Mohammad Rafique,2000-2008,33,48,7,7,0,0,7,1 (1ct 0st),0.145,BDESH,2000,2008
1137,Mohammad Sami,2001-2012,36,66,7,7,0,0,7,2 (2ct 0st),0.106,PAK,2001,2012
1138,S Mushtaq Ali,1934-1952,11,19,7,7,0,0,7,1 (1ct 0st),0.368,INDIA,1934,1952
1139,Nazar Mohammad,1952-1952,5,8,7,7,0,0,7,2 (2ct 0st),0.875,PAK,1952,1952
1140,ASM Oakman,1956-1956,2,4,7,7,0,0,7,3 (3ct 0st),1.75,ENG,1956,1956
1141,IE O'Brien,2005-2009,22,38,7,7,0,0,7,2 (2ct 0st),0.184,NZ,2005,2009
1142,WJ O'Reilly,1932-1946,27,50,7,7,0,0,7,2 (2ct 0st),0.14,AUS,1932,1946
1143,HH Pandya,2017-2018,11,21,7,7,0,0,7,1 (1ct 0st),0.3329999999999999,INDIA,2017,2018
1144,E Paynter,1931-1939,20,37,7,7,0,0,7,1 (1ct 0st),0.1889999999999999,ENG,1931,1939
1145,JSE Price,1964-1972,15,28,7,7,0,0,7,2 (2ct 0st),0.25,ENG,1964,1972
1146,AMB Rowan,1947-1951,15,28,7,7,0,0,7,2 (2ct 0st),0.25,SA,1947,1951
1147,Sami Aslam,2015-2017,13,25,7,7,0,0,7,2 (2ct 0st),0.28,PAK,2015,2017
1148,VJ Scott,1946-1952,10,14,7,7,0,0,7,2 (2ct 0st),0.5,NZ,1946,1952
1149,JED Sealy,1930-1939,11,21,7,6,1,4,2,2 (1ct 1st),0.3329999999999999,WI,1930,1939
1150,Shamsur Rahman,2014-2014,6,11,7,7,0,0,7,2 (2ct 0st),0.636,BDESH,2014,2014
1151,C Sharma,1984-1989,23,40,7,7,0,0,7,1 (1ct 0st),0.175,INDIA,1984,1989
1152,M Sherwin,1887-1888,3,6,7,5,2,5,0,4 (2ct 2st),1.166,ENG,1887,1888
1153,IJ Siedle,1928-1936,18,29,7,7,0,0,7,2 (2ct 0st),0.241,SA,1928,1936
1154,Sikander Bakht,1976-1983,26,48,7,7,0,0,7,1 (1ct 0st),0.145,PAK,1976,1983
1155,LPC Silva,2006-2008,11,21,7,7,0,0,7,2 (2ct 0st),0.3329999999999999,SL,2006,2008
1156,MC Snedden,1981-1990,25,42,7,7,0,0,7,2 (2ct 0st),0.166,NZ,1981,1990
1157,DS Steele,1975-1976,8,16,7,7,0,0,7,2 (2ct 0st),0.437,ENG,1975,1976
1158,JWA Taylor,2012-2016,7,13,7,7,0,0,7,2 (2ct 0st),0.5379999999999999,ENG,2012,2016
1159,SA Thomson,1990-1995,19,31,7,7,0,0,7,1 (1ct 0st),0.225,NZ,1990,1995
1160,EWT Tindill,1937-1947,5,8,7,6,1,6,0,2 (2ct 0st),0.875,NZ,1937,1947
1161,PHJ Trimborn,1967-1970,4,8,7,7,0,0,7,2 (2ct 0st),0.875,SA,1967,1970
1162,TR Veivers,1963-1967,21,38,7,7,0,0,7,2 (2ct 0st),0.184,AUS,1963,1967
1163,Wajahatullah Wasti,1999-2000,6,10,7,7,0,0,7,3 (3ct 0st),0.7,PAK,1999,2000
1164,WW Whysall,1925-1930,4,7,7,7,0,0,7,2 (2ct 0st),1.0,ENG,1925,1930
1165,WM Woodfull,1926-1934,35,65,7,7,0,0,7,2 (2ct 0st),0.107,AUS,1926,1934
1166,RD Woolley,1983-1984,2,3,7,7,0,7,0,3 (3ct 0st),2.333,AUS,1983,1984
1167,EE Achong,1930-1935,6,9,6,6,0,0,6,1 (1ct 0st),0.6659999999999999,WI,1930,1935
1168,CJ Adams,1999-2000,5,7,6,6,0,0,6,3 (3ct 0st),0.857,ENG,1999,2000
1169,Afsar Zazai,2018-2019,3,5,6,5,1,5,0,2 (2ct 0st),1.2,AFG,2018,2019
1170,AB Agarkar,1998-2006,26,48,6,6,0,0,6,1 (1ct 0st),0.125,INDIA,1998,2006
1171,HK Badani,2001-2001,4,7,6,6,0,0,6,2 (2ct 0st),0.857,INDIA,2001,2001
1172,AA Baig,1959-1967,10,17,6,6,0,0,6,1 (1ct 0st),0.352,INDIA,1959,1967
1173,OAC Banks,2003-2005,10,20,6,6,0,0,6,3 (3ct 0st),0.3,WI,2003,2005
1174,Basit Ali,1993-1995,19,35,6,6,0,0,6,1 (1ct 0st),0.171,PAK,1993,1995
1175,AJ Bell,1929-1935,16,27,6,6,0,0,6,1 (1ct 0st),0.222,SA,1929,1935
1176,TL Best,2003-2013,25,46,6,6,0,0,6,1 (1ct 0st),0.13,WI,2003,2013
1177,C Blythe,1901-1910,19,37,6,6,0,0,6,1 (1ct 0st),0.162,ENG,1901,1910
1178,RS Bopara,2007-2012,13,20,6,6,0,0,6,2 (2ct 0st),0.3,ENG,2007,2012
1179,GE Bradburn,1990-2001,7,11,6,6,0,0,6,2 (2ct 0st),0.545,NZ,1990,2001
1180,W Brockwell,1893-1899,7,13,6,6,0,0,6,1 (1ct 0st),0.461,ENG,1893,1899
1181,SSJ Brooks,2019-2019,3,6,6,6,0,0,6,2 (2ct 0st),1.0,WI,2019,2019
1182,DJ Capel,1987-1990,15,24,6,6,0,0,6,2 (2ct 0st),0.25,ENG,1987,1990
1183,W Carkeek,1912-1912,6,9,6,6,0,6,0,2 (2ct 0st),0.6659999999999999,AUS,1912,1912
1184,E Chigumbura,2004-2014,14,24,6,6,0,0,6,2 (2ct 0st),0.25,ZIM,2004,2014
1185,WM Clark,1977-1979,10,18,6,6,0,0,6,1 (1ct 0st),0.3329999999999999,AUS,1977,1979
1186,CD Collymore,1999-2007,30,58,6,6,0,0,6,1 (1ct 0st),0.103,WI,1999,2007
1187,SC Cook,2016-2017,11,20,6,6,0,0,6,2 (2ct 0st),0.3,SA,2016,2017
1188,V Dahiya,2000-2000,2,4,6,6,0,6,0,3 (3ct 0st),1.5,INDIA,2000,2000
1189,RL Dias,1982-1987,20,30,6,6,0,0,6,2 (2ct 0st),0.2,SL,1982,1987
1190,AIC Dodemaide,1987-1992,10,17,6,6,0,0,6,2 (2ct 0st),0.352,AUS,1987,1992
1191,PA Emery,1994-1994,1,2,6,5,1,5,0,5 (4ct 1st),3.0,AUS,1994,1994
1192,FL Fane,1906-1910,14,27,6,6,0,0,6,1 (1ct 0st),0.222,ENG,1906,1910
1193,CV Gadkari,1953-1955,6,10,6,6,0,0,6,3 (3ct 0st),0.6,INDIA,1953,1955
1194,DRA Gehrs,1904-1911,6,11,6,6,0,0,6,2 (2ct 0st),0.545,AUS,1904,1911
1195,Y Goonasekera,1983-1983,2,3,6,6,0,0,6,4 (4ct 0st),2.0,SL,1983,1983
1196,AH Gray,1986-1987,5,10,6,6,0,0,6,3 (3ct 0st),0.6,WI,1986,1987
1197,EJ Gray,1983-1988,10,17,6,6,0,0,6,2 (2ct 0st),0.352,NZ,1983,1988
1198,DAS Gunaratne,2016-2017,6,12,6,6,0,0,6,2 (2ct 0st),0.5,SL,2016,2017
1199,MD Gunathilaka,2017-2018,8,15,6,6,0,0,6,1 (1ct 0st),0.4,SL,2017,2018
1200,WA Hadlee,1937-1951,11,17,6,6,0,0,6,2 (2ct 0st),0.352,NZ,1937,1951
1201,PGZ Harris,1955-1965,9,15,6,6,0,0,6,3 (3ct 0st),0.4,NZ,1955,1965
1202,TP Horan,1877-1885,15,28,6,6,0,0,6,1 (1ct 0st),0.214,AUS,1877,1885
1203,HV Hordern,1911-1912,7,13,6,6,0,0,6,2 (2ct 0st),0.461,AUS,1911,1912
1204,AS Joseph,2016-2019,9,17,6,6,0,0,6,1 (1ct 0st),0.352,WI,2016,2019
1205,SMS Kaluperuma,1984-1988,4,6,6,6,0,0,6,2 (2ct 0st),1.0,SL,1984,1988
1206,CK Kapugedera,2006-2009,8,15,6,6,0,0,6,2 (2ct 0st),0.4,SL,2006,2009
1207,MF Kent,1981-1981,3,6,6,6,0,0,6,3 (3ct 0st),1.0,AUS,1981,1981
1208,R Kilner,1924-1926,9,13,6,6,0,0,6,2 (2ct 0st),0.461,ENG,1924,1926
1209,James Langridge,1933-1946,8,15,6,6,0,0,6,2 (2ct 0st),0.4,ENG,1933,1946
1210,CN McCarthy,1948-1951,15,26,6,6,0,0,6,1 (1ct 0st),0.23,SA,1948,1951
1211,PS McDonnell,1880-1888,19,34,6,6,0,0,6,2 (2ct 0st),0.176,AUS,1880,1888
1212,PJ Martin,1995-1997,8,13,6,6,0,0,6,1 (1ct 0st),0.461,ENG,1995,1997
1213,TBA May,1987-1995,24,46,6,6,0,0,6,1 (1ct 0st),0.13,AUS,1987,1995
1214,Mehrab Hossain,2000-2003,9,11,6,6,0,2,4,2 (2ct 0st),0.545,BDESH,2000,2003
1215,CR Miller,1998-2001,18,34,6,6,0,0,6,1 (1ct 0st),0.176,AUS,1998,2001
1216,FM Misson,1960-1961,5,10,6,6,0,0,6,2 (2ct 0st),0.6,AUS,1960,1961
1217,Mohammad Ilyas,1964-1969,10,19,6,6,0,0,6,2 (2ct 0st),0.315,PAK,1964,1969
1218,A Mukund,2011-2017,7,14,6,6,0,0,6,2 (2ct 0st),0.428,INDIA,2011,2017
1219,AD Mullally,1996-2001,19,34,6,6,0,0,6,1 (1ct 0st),0.176,ENG,1996,2001
1220,DJ Murray,1994-1995,8,14,6,6,0,0,6,2 (2ct 0st),0.428,NZ,1994,1995
1221,Mushfiqur Rahman,2001-2004,10,15,6,6,0,0,6,2 (2ct 0st),0.4,BDESH,2001,2004
1222,Nadeem Abbasi,1989-1989,3,5,6,6,0,6,0,2 (2ct 0st),1.2,PAK,1989,1989
1223,KK Nair,2016-2017,6,12,6,6,0,0,6,2 (2ct 0st),0.5,INDIA,2016,2017
1224,BP Nash,2008-2011,21,37,6,6,0,0,6,1 (1ct 0st),0.162,WI,2008,2011
1225,LJ Nash,1932-1937,2,4,6,6,0,0,6,2 (2ct 0st),1.5,AUS,1932,1937
1226,SB O'Connor,1997-2001,19,35,6,6,0,0,6,2 (2ct 0st),0.171,NZ,1997,2001
1227,ML Page,1930-1937,14,22,6,6,0,0,6,2 (2ct 0st),0.272,NZ,1930,1937
1228,BH Pairaudeau,1953-1957,13,25,6,6,0,0,6,1 (1ct 0st),0.24,WI,1953,1957
1229,JT Partridge,1963-1965,11,20,6,6,0,0,6,1 (1ct 0st),0.3,SA,1963,1965
1230,MM Patel,2006-2011,13,25,6,6,0,0,6,2 (2ct 0st),0.24,INDIA,2006,2011
1231,KR Patterson,2019-2019,2,4,6,6,0,0,6,2 (2ct 0st),1.5,AUS,2019,2019
1232,DB Pithey,1963-1967,8,16,6,6,0,0,6,2 (2ct 0st),0.375,SA,1963,1967
1233,BKV Prasad,1996-2001,33,59,6,6,0,0,6,1 (1ct 0st),0.1009999999999999,INDIA,1996,2001
1234,KTGD Prasad,2008-2015,25,47,6,6,0,0,6,2 (2ct 0st),0.127,SL,2008,2015
1235,SLV Raju,1990-2001,28,52,6,6,0,0,6,1 (1ct 0st),0.115,INDIA,1990,2001
1236,WV Raman,1988-1997,11,21,6,6,0,0,6,2 (2ct 0st),0.285,INDIA,1988,1997
1237,CPH Ramanayake,1988-1993,18,30,6,6,0,0,6,1 (1ct 0st),0.2,SL,1988,1993
1238,FL Reifer,1997-2009,6,12,6,6,0,0,6,2 (2ct 0st),0.5,WI,1997,2009
1239,PE Richardson,1956-1963,34,65,6,6,0,0,6,1 (1ct 0st),0.092,ENG,1956,1963
1240,JDB Robertson,1947-1952,11,19,6,6,0,0,6,1 (1ct 0st),0.315,ENG,1947,1952
1241,PADLR Sandakan,2016-2018,11,21,6,6,0,0,6,1 (1ct 0st),0.285,SL,2016,2018
1242,S Shivnarine,1978-1979,8,13,6,6,0,0,6,2 (2ct 0st),0.461,WI,1978,1979
1243,JM Sims,1935-1937,4,8,6,6,0,0,6,3 (3ct 0st),0.75,ENG,1935,1937
1244,RP Singh,2006-2011,14,25,6,6,0,0,6,1 (1ct 0st),0.24,INDIA,2006,2011
1245,MJ Stewart,1962-1964,8,16,6,6,0,0,6,2 (2ct 0st),0.375,ENG,1962,1964
1246,AE Stoddart,1888-1898,16,29,6,6,0,0,6,1 (1ct 0st),0.206,ENG,1888,1898
1247,Tapash Baisya,2002-2005,21,29,6,6,0,0,6,1 (1ct 0st),0.206,BDESH,2002,2005
1248,Lord Tennyson,1913-1921,9,16,6,6,0,0,6,2 (2ct 0st),0.375,ENG,1913,1921
1249,TL Tsolekile,2004-2004,3,5,6,6,0,6,0,3 (3ct 0st),1.2,SA,2004,2004
1250,MG Vandort,2001-2008,20,39,6,6,0,0,6,1 (1ct 0st),0.153,SL,2001,2008
1251,S van Zyl,2014-2016,12,20,6,6,0,0,6,1 (1ct 0st),0.3,SA,2014,2016
1252,MA Vermeulen,2002-2014,9,14,6,6,0,0,6,1 (1ct 0st),0.428,ZIM,2002,2014
1253,CF Walters,1933-1934,11,21,6,6,0,0,6,2 (2ct 0st),0.285,ENG,1933,1934
1254,JC White,1921-1931,15,29,6,6,0,0,6,1 (1ct 0st),0.206,ENG,1921,1931
1255,GC Wilson,2018-2019,2,4,6,6,0,6,0,3 (3ct 0st),1.5,IRE,2018,2019
1256,B Wood,1972-1978,12,23,6,6,0,0,6,2 (2ct 0st),0.26,ENG,1972,1978
1257,GEC Wood,1924-1924,3,6,6,5,1,5,0,2 (2ct 0st),1.0,ENG,1924,1924
1258,RA Young,1907-1908,2,4,6,6,0,6,0,2 (2ct 0st),1.5,ENG,1907,1908
1259,Alok Kapali,2002-2006,17,25,5,5,0,0,5,2 (2ct 0st),0.2,BDESH,2002,2006
1260,Aminul Islam,2000-2002,13,16,5,5,0,0,5,3 (3ct 0st),0.312,BDESH,2000,2002
1261,Asif Masood,1969-1977,16,29,5,5,0,0,5,1 (1ct 0st),0.172,PAK,1969,1977
1262,Atiq-uz-Zaman,2000-2000,1,2,5,5,0,5,0,3 (3ct 0st),2.5,PAK,2000,2000
1263,XC Balaskas,1930-1939,9,14,5,5,0,0,5,1 (1ct 0st),0.357,SA,1930,1939
1264,BA Barnett,1938-1938,4,6,5,3,2,3,0,3 (2ct 1st),0.833,AUS,1938,1938
1265,MJ Bennett,1984-1985,3,5,5,5,0,0,5,1 (1ct 0st),1.0,AUS,1984,1985
1266,MC Bird,1910-1914,10,20,5,5,0,0,5,3 (3ct 0st),0.25,ENG,1910,1914
1267,RW Blair,1953-1964,19,28,5,5,0,0,5,1 (1ct 0st),0.178,NZ,1953,1964
1268,RC Blunt,1930-1932,9,14,5,5,0,0,5,2 (2ct 0st),0.357,NZ,1930,1932
1269,KD Boyce,1971-1976,21,41,5,5,0,0,5,1 (1ct 0st),0.121,WI,1971,1976
1270,NGB Cook,1983-1989,15,25,5,5,0,0,5,2 (2ct 0st),0.2,ENG,1983,1989
1271,RRS Cornwall,2019-2019,2,4,5,5,0,0,5,2 (2ct 0st),1.25,WI,2019,2019
1272,CS Cowdrey,1984-1988,6,12,5,5,0,0,5,2 (2ct 0st),0.416,ENG,1984,1988
1273,CE Cuffy,1994-2002,15,26,5,5,0,0,5,1 (1ct 0st),0.192,WI,1994,2002
1274,SH Curnow,1930-1932,7,11,5,5,0,0,5,3 (3ct 0st),0.4539999999999999,SA,1930,1932
1275,OC da Costa,1930-1935,5,7,5,5,0,0,5,3 (3ct 0st),0.7140000000000001,WI,1930,1935
1276,EL Dalton,1929-1939,15,26,5,5,0,0,5,2 (2ct 0st),0.192,SA,1929,1939
1277,WM Darling,1978-1979,14,25,5,5,0,0,5,2 (2ct 0st),0.2,AUS,1978,1979
1278,JL Denly,2019-2019,11,21,5,5,0,0,5,1 (1ct 0st),0.238,ENG,2019,2019
1279,AM de Silva,1993-1993,3,4,5,4,1,4,0,2 (2ct 0st),1.25,SL,1993,1993
1280,DS de Silva,1982-1984,12,19,5,5,0,0,5,2 (2ct 0st),0.263,SL,1982,1984
1281,KSC de Silva,1997-1999,8,14,5,5,0,0,5,2 (2ct 0st),0.357,SL,1997,1999
1282,RV Divecha,1951-1952,5,7,5,5,0,0,5,2 (2ct 0st),0.7140000000000001,INDIA,1951,1952
1283,TM Dowlin,2009-2010,6,11,5,5,0,0,5,2 (2ct 0st),0.4539999999999999,WI,2009,2010
1284,NF Druce,1897-1898,5,8,5,5,0,1,4,2 (2ct 0st),0.625,ENG,1897,1898
1285,CE Eksteen,1993-2000,7,14,5,5,0,0,5,1 (1ct 0st),0.357,SA,1993,2000
1286,RMS Eranga,2011-2016,19,36,5,5,0,0,5,1 (1ct 0st),0.138,SL,2011,2016
1287,E Evans,1881-1886,6,10,5,5,0,0,5,2 (2ct 0st),0.5,AUS,1881,1886
1288,AE Fagg,1936-1939,5,10,5,5,0,0,5,2 (2ct 0st),0.5,ENG,1936,1939
1289,N Pradeep,2011-2017,28,53,5,5,0,0,5,1 (1ct 0st),0.094,SL,2011,2017
1290,FGJ Ford,1894-1895,5,9,5,5,0,0,5,2 (2ct 0st),0.555,ENG,1894,1895
1291,CM Francois,1922-1923,5,10,5,5,0,0,5,3 (3ct 0st),0.5,SA,1922,1923
1292,EW Freeman,1968-1970,11,21,5,5,0,0,5,1 (1ct 0st),0.238,AUS,1968,1970
1293,DK Gaekwad,1952-1961,11,17,5,5,0,0,5,1 (1ct 0st),0.294,INDIA,1952,1961
1294,D Gamsy,1970-1970,2,4,5,5,0,5,0,3 (3ct 0st),1.25,SA,1970,1970
1295,AE Greenidge,1978-1979,6,10,5,5,0,0,5,2 (2ct 0st),0.5,WI,1978,1979
1296,AFG Griffith,1997-2000,14,24,5,5,0,0,5,1 (1ct 0st),0.208,WI,1997,2000
1297,SC Griffith,1948-1949,3,6,5,5,0,5,0,3 (3ct 0st),0.833,ENG,1948,1949
1298,W Gunn,1887-1899,11,21,5,5,0,0,5,2 (2ct 0st),0.238,ENG,1887,1899
1299,JN Hamilton,2019-2019,1,2,5,5,0,5,0,3 (3ct 0st),2.5,WI,2019,2019
1300,BR Hartland,1992-1994,9,15,5,5,0,0,5,3 (3ct 0st),0.3329999999999999,NZ,1992,1994
1301,Hasan Raza,1996-2005,7,13,5,5,0,0,5,2 (2ct 0st),0.384,PAK,1996,2005
1302,CMH Hathorn,1902-1911,12,23,5,5,0,0,5,1 (1ct 0st),0.217,SA,1902,1911
1303,EE Hemmings,1982-1991,16,28,5,5,0,0,5,1 (1ct 0st),0.178,ENG,1982,1991
1304,MJ Henry,2015-2019,11,21,5,5,0,0,5,2 (2ct 0st),0.238,NZ,2015,2019
1305,ND Hirwani,1988-1996,17,31,5,5,0,0,5,1 (1ct 0st),0.161,INDIA,1988,1996
1306,RG Holland,1984-1986,11,18,5,5,0,0,5,2 (2ct 0st),0.2769999999999999,AUS,1984,1986
1307,DT Hondo,2001-2005,9,13,5,5,0,0,5,2 (2ct 0st),0.384,ZIM,2001,2005
1308,EAC Hunte,1930-1930,3,6,5,5,0,5,0,3 (3ct 0st),0.833,WI,1930,1930
1309,Ijaz Butt,1959-1962,8,13,5,5,0,2,3,2 (2ct 0st),0.384,PAK,1959,1962
1310,Ikram Alikhil,2019-2019,1,2,5,4,1,4,0,3 (2ct 1st),2.5,AFG,2019,2019
1311,RK Illingworth,1991-1995,9,14,5,5,0,0,5,2 (2ct 0st),0.357,ENG,1991,1995
1312,A Jadeja,1992-2000,15,25,5,5,0,0,5,2 (2ct 0st),0.2,INDIA,1992,2000
1313,TJ Jenner,1970-1975,9,18,5,5,0,0,5,2 (2ct 0st),0.2769999999999999,AUS,1970,1975
1314,CB Jennings,1912-1912,6,9,5,5,0,0,5,2 (2ct 0st),0.555,AUS,1912,1912
1315,VWC Jupp,1921-1928,8,15,5,5,0,0,5,1 (1ct 0st),0.3329999999999999,ENG,1921,1928
1316,AS Kennedy,1922-1923,5,9,5,5,0,0,5,2 (2ct 0st),0.555,ENG,1922,1923
1317,D Kenyon,1951-1955,8,15,5,5,0,0,5,2 (2ct 0st),0.3329999999999999,ENG,1951,1955
1318,CL King,1976-1980,9,17,5,5,0,0,5,2 (2ct 0st),0.294,WI,1976,1980
1319,FM King,1953-1956,14,26,5,5,0,0,5,2 (2ct 0st),0.192,WI,1953,1956
1320,R Lamba,1986-1987,4,7,5,5,0,0,5,3 (3ct 0st),0.7140000000000001,INDIA,1986,1987
1321,GR Larsen,1994-1996,8,15,5,5,0,0,5,2 (2ct 0st),0.3329999999999999,NZ,1994,1996
1322,JDF Larter,1962-1965,10,20,5,5,0,0,5,2 (2ct 0st),0.25,ENG,1962,1965
1323,RT Latham,1992-1993,4,8,5,5,0,0,5,2 (2ct 0st),0.625,NZ,1992,1993
1324,MJ Leach,2018-2019,10,19,5,5,0,0,5,1 (1ct 0st),0.263,ENG,2018,2019
1325,JD Lindsay,1947-1947,3,6,5,4,1,4,0,2 (1ct 1st),0.833,SA,1947,1947
1326,FA Lowson,1951-1955,7,12,5,5,0,0,5,2 (2ct 0st),0.416,ENG,1951,1955
1327,GG Macaulay,1923-1933,8,14,5,5,0,0,5,1 (1ct 0st),0.357,ENG,1923,1933
1328,PE McEwan,1980-1984,4,8,5,5,0,0,5,2 (2ct 0st),0.625,NZ,1980,1984
1329,NAM McLean,1998-2001,19,33,5,5,0,0,5,1 (1ct 0st),0.151,WI,1998,2001
1330,EDAS McMorris,1958-1966,13,25,5,5,0,0,5,1 (1ct 0st),0.2,WI,1958,1966
1331,Mahmood Hussain,1952-1962,27,45,5,5,0,0,5,1 (1ct 0st),0.111,PAK,1952,1962
1332,JAH Marshall,2005-2008,7,13,5,5,0,0,5,1 (1ct 0st),0.384,NZ,2005,2008
1333,JW Martin,1960-1967,8,16,5,5,0,0,5,3 (3ct 0st),0.312,AUS,1960,1967
1334,EA Martindale,1933-1939,10,17,5,5,0,0,5,1 (1ct 0st),0.294,WI,1933,1939
1335,HH Massie,1881-1885,9,17,5,5,0,0,5,1 (1ct 0st),0.294,AUS,1881,1885
1336,GJ Maxwell,2013-2017,7,12,5,5,0,0,5,2 (2ct 0st),0.416,AUS,2013,2017
1337,CA Milton,1958-1959,6,12,5,5,0,0,5,2 (2ct 0st),0.416,ENG,1958,1959
1338,Mohammad Abbas,2017-2019,17,31,5,5,0,0,5,2 (2ct 0st),0.161,PAK,2017,2019
1339,Mohammad Amir,2009-2019,36,69,5,5,0,0,5,1 (1ct 0st),0.072,PAK,2009,2019
1340,Mohammad Sharif,2001-2007,10,12,5,5,0,0,5,2 (2ct 0st),0.416,BDESH,2001,2007
1341,CH Morris,2016-2017,4,8,5,5,0,0,5,2 (2ct 0st),0.625,SA,2016,2017
1342,A Nehra,1999-2004,17,30,5,5,0,0,5,1 (1ct 0st),0.166,INDIA,1999,2004
1343,AD Ogilvie,1977-1978,5,10,5,5,0,0,5,1 (1ct 0st),0.5,AUS,1977,1978
1344,NV Ojha,2015-2015,1,2,5,4,1,4,0,3 (2ct 1st),2.5,INDIA,2015,2015
1345,GAE Paine,1935-1935,4,7,5,5,0,0,5,2 (2ct 0st),0.7140000000000001,ENG,1935,1935
1346,AY Patel,2018-2019,7,13,5,5,0,0,5,2 (2ct 0st),0.384,NZ,2018,2019
1347,BP Patterson,1986-1992,28,54,5,5,0,0,5,1 (1ct 0st),0.092,WI,1986,1992
1348,JL Pattinson,2011-2019,20,38,5,5,0,0,5,1 (1ct 0st),0.131,AUS,2011,2019
1349,TRO Payne,1986-1986,1,2,5,5,0,5,0,3 (3ct 0st),2.5,WI,1986,1986
1350,IAR Peebles,1927-1931,13,21,5,5,0,0,5,1 (1ct 0st),0.238,ENG,1927,1931
1351,SJ Pegler,1910-1924,16,24,5,5,0,0,5,2 (2ct 0st),0.208,SA,1910,1924
1352,N Phillip,1978-1979,9,15,5,5,0,0,5,2 (2ct 0st),0.3329999999999999,WI,1978,1979
1353,PI Philpott,1965-1966,8,15,5,5,0,0,5,2 (2ct 0st),0.3329999999999999,AUS,1965,1966
1354,DL Piedt,2014-2019,9,16,5,5,0,0,5,2 (2ct 0st),0.312,SA,2014,2019
1355,BA Pocock,1993-1997,15,24,5,5,0,0,5,1 (1ct 0st),0.208,NZ,1993,1997
1356,OJ Pope,2018-2019,4,7,5,5,0,1,4,2 (2ct 0st),0.7140000000000001,ENG,2018,2019
1357,PH Punjabi,1955-1955,5,9,5,5,0,0,5,1 (1ct 0st),0.555,INDIA,1955,1955
1358,RJ Quiney,2012-2012,2,4,5,5,0,0,5,2 (2ct 0st),1.25,AUS,2012,2012
1359,GO Rabone,1949-1955,12,19,5,5,0,0,5,2 (2ct 0st),0.263,NZ,1949,1955
1360,AJ Redmond,2008-2013,8,12,5,5,0,0,5,2 (2ct 0st),0.416,NZ,2008,2013
1361,BA Reid,1985-1992,27,46,5,5,0,0,5,1 (1ct 0st),0.108,AUS,1985,1992
1362,T Richardson,1893-1898,14,25,5,5,0,0,5,1 (1ct 0st),0.2,ENG,1893,1898
1363,KE Rigg,1931-1937,8,16,5,5,0,0,5,1 (1ct 0st),0.312,AUS,1931,1937
1364,DT Ring,1948-1953,13,26,5,5,0,0,5,1 (1ct 0st),0.192,AUS,1948,1953
1365,CA Roach,1928-1935,16,23,5,5,0,0,5,1 (1ct 0st),0.217,WI,1928,1935
1366,Robiul Islam,2010-2014,9,17,5,5,0,0,5,1 (1ct 0st),0.294,BDESH,2010,2014
1367,SD Robson,2014-2014,7,14,5,5,0,0,5,1 (1ct 0st),0.357,ENG,2014,2014
1368,L Ronchi,2015-2016,4,8,5,5,0,5,0,2 (2ct 0st),0.625,NZ,2015,2016
1369,IDK Salisbury,1992-2000,15,27,5,5,0,0,5,2 (2ct 0st),0.185,ENG,1992,2000
1370,DP Samaraweera,1993-1995,7,9,5,5,0,0,5,2 (2ct 0st),0.555,SL,1993,1995
1371,JV Saunders,1902-1908,14,27,5,5,0,0,5,2 (2ct 0st),0.185,AUS,1902,1908
1372,Shafqat Rana,1964-1969,5,9,5,5,0,0,5,2 (2ct 0st),0.555,PAK,1964,1969
1373,Shahid Nazir,1996-2007,15,29,5,5,0,0,5,2 (2ct 0st),0.172,PAK,1996,2007
1374,RJ Sidebottom,2001-2010,22,37,5,5,0,0,5,1 (1ct 0st),0.135,ENG,2001,2010
1375,LMP Simmons,2009-2011,8,15,5,5,0,0,5,1 (1ct 0st),0.3329999999999999,WI,2009,2011
1376,RT Simpson,1948-1955,27,51,5,5,0,0,5,2 (2ct 0st),0.098,ENG,1948,1955
1377,RR Singh,1998-1998,1,2,5,5,0,0,5,3 (3ct 0st),2.5,INDIA,1998,1998
1378,CL Smith,1983-1986,8,16,5,5,0,0,5,2 (2ct 0st),0.312,ENG,1983,1986
1379,CW Smith,1960-1962,5,10,5,4,1,1,3,3 (3ct 0st),0.5,WI,1960,1962
1380,ET Smith,2003-2003,3,6,5,5,0,0,5,2 (2ct 0st),0.833,ENG,2003,2003
1381,Sohag Gazi,2012-2014,10,18,5,5,0,0,5,1 (1ct 0st),0.2769999999999999,BDESH,2012,2014
1382,S Sreesanth,2006-2011,27,50,5,5,0,0,5,2 (2ct 0st),0.1,INDIA,2006,2011
1383,AG Steel,1880-1888,13,24,5,5,0,0,5,1 (1ct 0st),0.208,ENG,1880,1888
1384,CT Studd,1882-1883,5,10,5,5,0,0,5,2 (2ct 0st),0.5,ENG,1882,1883
1385,R Subba Row,1958-1961,13,23,5,5,0,0,5,1 (1ct 0st),0.217,ENG,1958,1961
1386,PL Symcox,1993-1998,20,35,5,5,0,0,5,2 (2ct 0st),0.142,SA,1993,1998
1387,GJ Thompson,1909-1910,6,12,5,5,0,0,5,2 (2ct 0st),0.416,ENG,1909,1910
1388,RW Tolchard,1977-1977,4,8,5,5,0,0,5,1 (1ct 0st),0.625,ENG,1977,1977
1389,RG Twose,1995-1999,16,28,5,5,0,0,5,1 (1ct 0st),0.178,NZ,1995,1999
1390,KG Viljoen,1930-1949,27,46,5,5,0,0,5,1 (1ct 0st),0.108,SA,1930,1949
1391,Wahab Riaz,2010-2018,27,52,5,5,0,0,5,1 (1ct 0st),0.096,PAK,2010,2018
1392,PM Walker,1960-1960,3,6,5,5,0,0,5,2 (2ct 0st),0.833,ENG,1960,1960
1393,WM Wallace,1937-1953,13,20,5,5,0,0,5,1 (1ct 0st),0.25,NZ,1937,1953
1394,Wazir Mohammad,1952-1959,20,37,5,5,0,0,5,1 (1ct 0st),0.135,PAK,1952,1959
1395,UWMBCA Welegedara,2007-2014,21,36,5,5,0,0,5,1 (1ct 0st),0.138,SL,2007,2014
1396,DM Wellham,1981-1987,6,10,5,5,0,0,5,2 (2ct 0st),0.5,AUS,1981,1987
1397,AB Williams,1978-1979,7,12,5,5,0,0,5,2 (2ct 0st),0.416,WI,1978,1979
1398,MA Wood,2015-2019,13,25,5,5,0,0,5,1 (1ct 0st),0.2,ENG,2015,2019
1399,SMJ Woods,1888-1896,6,10,5,5,0,0,5,3 (3ct 0st),0.5,AUS/ENG,1888,1896
1400,JA Young,1947-1949,8,14,5,5,0,0,5,1 (1ct 0st),0.357,ENG,1947,1949
1401,Zahid Fazal,1990-1995,9,16,5,5,0,0,5,1 (1ct 0st),0.312,PAK,1990,1995
1402,Zulfiqar Ahmed,1952-1956,9,16,5,5,0,0,5,1 (1ct 0st),0.312,PAK,1952,1956
1403,KJ Abbott,2013-2017,11,21,4,4,0,0,4,1 (1ct 0st),0.19,SA,2013,2017
1404,Abdur Razzak,2006-2018,13,21,4,4,0,0,4,1 (1ct 0st),0.19,BDESH,2006,2018
1405,EL a'Beckett,1928-1932,4,8,4,4,0,0,4,2 (2ct 0st),0.5,AUS,1928,1932
1406,NAT Adcock,1953-1962,26,48,4,4,0,0,4,1 (1ct 0st),0.083,SA,1953,1962
1407,PJW Allott,1981-1985,13,24,4,4,0,0,4,1 (1ct 0st),0.166,ENG,1981,1985
1408,S Amarnath,1976-1978,10,17,4,4,0,0,4,2 (2ct 0st),0.235,INDIA,1976,1978
1409,SD Anurasiri,1986-1998,18,27,4,4,0,0,4,1 (1ct 0st),0.148,SL,1986,1998
1410,R Appleyard,1954-1956,9,18,4,4,0,0,4,2 (2ct 0st),0.222,ENG,1954,1956
1411,KJ Arnott,1992-1993,4,6,4,4,0,0,4,2 (2ct 0st),0.6659999999999999,ZIM,1992,1993
1412,HMCM Bandara,1998-2006,8,15,4,4,0,0,4,1 (1ct 0st),0.266,SL,1998,2006
1413,SB Bangar,2001-2002,12,22,4,4,0,0,4,1 (1ct 0st),0.181,INDIA,2001,2002
1414,PT Barton,1961-1963,7,11,4,4,0,0,4,2 (2ct 0st),0.363,NZ,1961,1963
1415,G Bean,1892-1892,3,6,4,4,0,0,4,2 (2ct 0st),0.6659999999999999,ENG,1892,1892
1416,STR Binny,2014-2015,6,9,4,4,0,0,4,1 (1ct 0st),0.444,INDIA,2014,2015
1417,LS Birkett,1930-1931,4,5,4,4,0,0,4,2 (2ct 0st),0.8,WI,1930,1931
1418,EA Brandes,1992-1999,10,18,4,4,0,0,4,1 (1ct 0st),0.222,ZIM,1992,1999
1419,IG Butler,2002-2004,8,14,4,4,0,0,4,1 (1ct 0st),0.285,NZ,2002,2004
1420,MR Bynoe,1959-1967,4,8,4,4,0,0,4,1 (1ct 0st),0.5,WI,1959,1967
1421,GS Camacho,1968-1971,11,18,4,4,0,0,4,1 (1ct 0st),0.222,WI,1968,1971
1422,JD Campbell,2019-2019,6,12,4,4,0,0,4,1 (1ct 0st),0.3329999999999999,WI,2019,2019
1423,PVD Chameera,2015-2019,8,14,4,4,0,0,4,1 (1ct 0st),0.285,SL,2015,2019
1424,S Chattergoon,2008-2008,4,8,4,4,0,0,4,1 (1ct 0st),0.5,WI,2008,2008
1425,SR Clark,2006-2009,24,48,4,4,0,0,4,1 (1ct 0st),0.083,AUS,2006,2009
1426,IA Colquhoun,1955-1955,2,3,4,4,0,4,0,2 (2ct 0st),1.3330000000000002,NZ,1955,1955
1427,WW Daniel,1976-1984,10,20,4,4,0,0,4,1 (1ct 0st),0.2,WI,1976,1984
1428,CA Davis,1968-1973,15,27,4,4,0,0,4,1 (1ct 0st),0.148,WI,1968,1973
1429,HT Davis,1994-1997,5,9,4,4,0,0,4,1 (1ct 0st),0.444,NZ,1994,1997
1430,EAR de Silva,1985-1991,10,16,4,4,0,0,4,1 (1ct 0st),0.25,SL,1985,1991
1431,AJ Doolan,2014-2014,4,8,4,4,0,0,4,2 (2ct 0st),0.5,AUS,2014,2014
1432,CJ Drum,2001-2002,5,9,4,4,0,0,4,1 (1ct 0st),0.444,NZ,2001,2002
1433,MA Ealham,1996-1998,8,13,4,4,0,0,4,1 (1ct 0st),0.307,ENG,1996,1998
1434,MK Elgie,1961-1962,3,6,4,4,0,0,4,2 (2ct 0st),0.6659999999999999,SA,1961,1962
1435,NH Fairbrother,1987-1993,10,15,4,4,0,0,4,2 (2ct 0st),0.266,ENG,1987,1993
1436,TCB Fernando,2001-2002,9,17,4,4,0,0,4,2 (2ct 0st),0.235,SL,2001,2002
1437,JJ Ferris,1887-1892,9,16,4,4,0,0,4,1 (1ct 0st),0.25,AUS/ENG,1887,1892
1438,A Fielder,1904-1908,6,12,4,4,0,0,4,2 (2ct 0st),0.3329999999999999,ENG,1904,1908
1439,AP Freeman,1924-1929,12,23,4,4,0,0,4,1 (1ct 0st),0.173,ENG,1924,1929
1440,AB Fudadin,2012-2012,3,5,4,4,0,0,4,2 (2ct 0st),0.8,WI,2012,2012
1441,LH Gay,1894-1894,1,2,4,3,1,3,0,3 (2ct 1st),2.0,ENG,1894,1894
1442,JM Ghorpade,1953-1959,8,12,4,4,0,0,4,1 (1ct 0st),0.3329999999999999,INDIA,1953,1959
1443,PA Gibb,1938-1946,8,14,4,3,1,3,0,2 (1ct 1st),0.285,ENG,1938,1946
1444,R Gilchrist,1957-1959,13,23,4,4,0,0,4,1 (1ct 0st),0.173,WI,1957,1959
1445,HC Griffith,1928-1933,13,18,4,4,0,0,4,1 (1ct 0st),0.222,WI,1928,1933
1446,NE Haig,1921-1930,5,10,4,4,0,0,4,2 (2ct 0st),0.4,ENG,1921,1930
1447,AE Hall,1923-1931,7,14,4,4,0,0,4,1 (1ct 0st),0.285,SA,1923,1931
1448,H Hameed,2016-2016,3,6,4,4,0,0,4,3 (3ct 0st),0.6659999999999999,ENG,2016,2016
1449,Hasan Ali,2017-2019,9,17,4,4,0,0,4,1 (1ct 0st),0.235,PAK,2017,2019
1450,M Hayward,1999-2004,16,31,4,4,0,0,4,1 (1ct 0st),0.129,SA,1999,2004
1451,GR Hazlitt,1907-1912,9,15,4,4,0,0,4,1 (1ct 0st),0.266,AUS,1907,1912
1452,JT Hearne,1892-1899,12,22,4,4,0,0,4,2 (2ct 0st),0.181,ENG,1892,1899
1453,K Higgs,1965-1968,15,27,4,4,0,0,4,1 (1ct 0st),0.148,ENG,1965,1968
1454,JW Hitch,1911-1921,7,12,4,4,0,0,4,1 (1ct 0st),0.3329999999999999,ENG,1911,1921
1455,AJ Hollioake,1997-1998,4,6,4,4,0,0,4,1 (1ct 0st),0.6659999999999999,ENG,1997,1998
1456,ERT Holmes,1935-1935,5,9,4,4,0,0,4,2 (2ct 0st),0.444,ENG,1935,1935
1457,ND Howard,1951-1952,4,7,4,4,0,0,4,2 (2ct 0st),0.5710000000000001,ENG,1951,1952
1458,Ibrahim Zadran,2019-2019,2,4,4,4,0,0,4,2 (2ct 0st),1.0,AFG,2019,2019
1459,Ihsanullah,2019-2019,3,6,4,4,0,0,4,2 (2ct 0st),0.6659999999999999,AFG,2019,2019
1460,Imran Nazir,1999-2002,8,14,4,4,0,0,4,1 (1ct 0st),0.285,PAK,1999,2002
1461,RJ Inverarity,1968-1972,6,12,4,4,0,0,4,2 (2ct 0st),0.3329999999999999,AUS,1968,1972
1462,M Jahangir Khan,1932-1936,4,7,4,4,0,0,4,3 (3ct 0st),0.5710000000000001,INDIA,1932,1936
1463,RO Jenkins,1948-1952,9,18,4,4,0,0,4,1 (1ct 0st),0.222,ENG,1948,1952
1464,IJ Jones,1964-1968,15,27,4,4,0,0,4,1 (1ct 0st),0.148,ENG,1964,1968
1465,PEW Jones,1948-1951,9,18,4,4,0,0,4,1 (1ct 0st),0.222,WI,1948,1951
1466,SP Jones,2002-2005,18,35,4,4,0,0,4,1 (1ct 0st),0.114,ENG,2002,2005
1467,BP Julian,1993-1995,7,14,4,4,0,0,4,1 (1ct 0st),0.285,AUS,1993,1995
1468,RR Jumadeen,1972-1979,12,22,4,4,0,0,4,2 (2ct 0st),0.181,WI,1972,1979
1469,Junaid Khan,2011-2015,22,43,4,4,0,0,4,2 (2ct 0st),0.093,PAK,2011,2015
1470,JL Kerr,1931-1937,7,10,4,4,0,0,4,2 (2ct 0st),0.4,NZ,1931,1937
1471,Khan Mohammad,1952-1958,13,22,4,4,0,0,4,2 (2ct 0st),0.181,PAK,1952,1958
1472,H Klaasen,2019-2019,1,1,4,3,1,3,0,4 (3ct 1st),4.0,SA,2019,2019
1473,JJ Krejza,2008-2008,2,4,4,4,0,0,4,3 (3ct 0st),1.0,AUS,2008,2008
1474,AG Kripal Singh,1955-1964,14,25,4,4,0,0,4,1 (1ct 0st),0.16,INDIA,1955,1964
1475,CBRLS Kumara,2016-2019,19,32,4,4,0,0,4,1 (1ct 0st),0.125,SL,2016,2019
1476,PD Lashley,1960-1966,4,8,4,4,0,0,4,2 (2ct 0st),0.5,WI,1960,1966
1477,WH Lockwood,1893-1902,12,20,4,4,0,0,4,2 (2ct 0st),0.2,ENG,1893,1902
1478,JE McConnon,1954-1954,2,4,4,4,0,0,4,4 (4ct 0st),1.0,ENG,1954,1954
1479,TR McKibbin,1895-1898,5,10,4,4,0,0,4,2 (2ct 0st),0.4,AUS,1895,1898
1480,DL Maddy,1999-2000,3,5,4,4,0,0,4,1 (1ct 0st),0.8,ENG,1999,2000
1481,Manjural Islam,2001-2004,17,22,4,4,0,0,4,1 (1ct 0st),0.181,BDESH,2001,2004
1482,FT Mann,1922-1923,5,9,4,4,0,0,4,1 (1ct 0st),0.444,ENG,1922,1923
1483,CR Matthews,1992-1995,18,33,4,4,0,0,4,2 (2ct 0st),0.121,SA,1992,1995
1484,CP Mead,1911-1928,17,31,4,4,0,0,4,1 (1ct 0st),0.129,ENG,1911,1928
1485,MG Melle,1950-1953,7,12,4,4,0,0,4,2 (2ct 0st),0.3329999999999999,SA,1950,1953
1486,KD Mills,2004-2009,19,33,4,4,0,0,4,1 (1ct 0st),0.121,NZ,2004,2009
1487,Mohammad Akram,1995-2001,9,15,4,4,0,0,4,1 (1ct 0st),0.266,PAK,1995,2001
1488,Mohammad Nazir,1969-1983,14,23,4,4,0,0,4,1 (1ct 0st),0.173,PAK,1969,1983
1489,Mohammad Salim,2003-2003,2,2,4,3,1,3,0,2 (2ct 0st),2.0,BDESH,2003,2003
1490,Mohsin Kamal,1984-1994,9,15,4,4,0,0,4,1 (1ct 0st),0.266,PAK,1984,1994
1491,LJ Moon,1906-1906,4,7,4,4,0,1,3,2 (2ct 0st),0.5710000000000001,ENG,1906,1906
1492,F Morley,1880-1883,4,8,4,4,0,0,4,2 (2ct 0st),0.5,ENG,1880,1883
1493,CB Mpofu,2005-2017,15,24,4,4,0,0,4,1 (1ct 0st),0.166,ZIM,2005,2017
1494,Naimur Rahman,2000-2002,8,11,4,4,0,0,4,2 (2ct 0st),0.363,BDESH,2000,2002
1495,CK Nayudu,1932-1936,7,13,4,4,0,0,4,1 (1ct 0st),0.307,INDIA,1932,1936
1496,ML Nkala,2000-2005,10,17,4,4,0,0,4,2 (2ct 0st),0.235,ZIM,2000,2005
1497,TC O'Brien,1884-1896,5,9,4,4,0,0,4,1 (1ct 0st),0.444,ENG,1884,1896
1498,SP O'Donnell,1985-1985,6,10,4,4,0,0,4,2 (2ct 0st),0.4,AUS,1985,1985
1499,S O'Linn,1960-1961,7,13,4,4,0,0,4,2 (2ct 0st),0.307,SA,1960,1961
1500,HGO Owen-Smith,1929-1929,5,9,4,4,0,0,4,2 (2ct 0st),0.444,SA,1929,1929
1501,RK Oxenham,1928-1931,7,14,4,4,0,0,4,1 (1ct 0st),0.285,AUS,1928,1931
1502,DR Parry,1978-1980,12,21,4,4,0,0,4,1 (1ct 0st),0.19,WI,1978,1980
1503,CT Patankar,1955-1956,1,2,4,3,1,3,0,4 (3ct 1st),2.0,INDIA,1955,1956
1504,CE Pellew,1920-1921,10,20,4,4,0,0,4,1 (1ct 0st),0.2,AUS,1920,1921
1505,PJ Petherick,1976-1977,6,12,4,4,0,0,4,2 (2ct 0st),0.3329999999999999,NZ,1976,1977
1506,WR Playle,1958-1963,8,10,4,4,0,0,4,1 (1ct 0st),0.4,NZ,1958,1963
1507,RW Price,1999-2013,22,37,4,4,0,0,4,2 (2ct 0st),0.108,ZIM,1999,2013
1508,MJ Procter,1967-1970,7,14,4,4,0,0,4,2 (2ct 0st),0.285,SA,1967,1970
1509,WG Quaife,1899-1902,7,14,4,4,0,0,4,2 (2ct 0st),0.285,ENG,1899,1902
1510,CT Radley,1978-1978,8,15,4,4,0,0,4,1 (1ct 0st),0.266,ENG,1978,1978
1511,V Rajindernath,1952-1952,1,2,4,0,4,0,0,2 (0ct 2st),2.0,INDIA,1952,1952
1512,CAK Rajitha,2018-2019,7,12,4,4,0,0,4,3 (3ct 0st),0.3329999999999999,SL,2018,2019
1513,AU Rashid,2015-2019,19,36,4,4,0,0,4,1 (1ct 0st),0.111,ENG,2015,2019
1514,DM Richards,2009-2010,3,6,4,4,0,0,4,1 (1ct 0st),0.6659999999999999,WI,2009,2010
1515,Rizwan-uz-Zaman,1981-1989,11,19,4,4,0,0,4,1 (1ct 0st),0.21,PAK,1981,1989
1516,ADG Roberts,1976-1976,7,14,4,4,0,0,4,1 (1ct 0st),0.285,NZ,1976,1976
1517,AW Roberts,1930-1937,5,9,4,4,0,0,4,1 (1ct 0st),0.444,NZ,1930,1937
1518,RD Robinson,1977-1977,3,5,4,4,0,0,4,1 (1ct 0st),0.8,AUS,1977,1977
1519,BC Rose,1977-1981,9,13,4,4,0,0,4,2 (2ct 0st),0.307,ENG,1977,1981
1520,FA Rose,1997-2000,19,33,4,4,0,0,4,2 (2ct 0st),0.121,WI,1997,2000
1521,GA Rowe,1896-1902,5,8,4,4,0,0,4,2 (2ct 0st),0.5,SA,1896,1902
1522,WE Russell,1961-1967,10,18,4,4,0,0,4,2 (2ct 0st),0.222,ENG,1961,1967
1523,S Samarawickrama,2017-2017,4,7,4,4,0,0,4,2 (2ct 0st),0.5710000000000001,SL,2017,2017
1524,A Sandham,1921-1930,14,24,4,4,0,0,4,1 (1ct 0st),0.166,ENG,1921,1930
1525,A Sanford,2002-2004,11,19,4,4,0,0,4,2 (2ct 0st),0.21,WI,2002,2004
1526,DN Sardesai,1961-1972,30,55,4,4,0,0,4,1 (1ct 0st),0.072,INDIA,1961,1972
1527,WH Scotton,1881-1887,15,28,4,4,0,0,4,2 (2ct 0st),0.142,ENG,1881,1887
1528,Shakeel Ahmed jnr,1993-1995,3,6,4,4,0,0,4,2 (2ct 0st),0.6659999999999999,PAK,1993,1995
1529,A Shaw,1877-1882,7,13,4,4,0,0,4,2 (2ct 0st),0.307,ENG,1877,1882
1530,JN Shepherd,1969-1971,5,10,4,4,0,0,4,2 (2ct 0st),0.4,WI,1969,1971
1531,MW Sievers,1936-1937,3,5,4,4,0,0,4,2 (2ct 0st),0.8,AUS,1936,1937
1532,PR Sleep,1979-1990,14,23,4,4,0,0,4,1 (1ct 0st),0.173,AUS,1979,1990
1533,RH Spooner,1905-1912,10,18,4,4,0,0,4,1 (1ct 0st),0.222,ENG,1905,1912
1534,PR Stirling,2018-2019,3,6,4,4,0,0,4,2 (2ct 0st),0.6659999999999999,IRE,2018,2019
1535,PM Such,1993-1999,11,20,4,4,0,0,4,2 (2ct 0st),0.2,ENG,1993,1999
1536,Surendranath,1958-1961,11,17,4,4,0,0,4,2 (2ct 0st),0.235,INDIA,1958,1961
1537,Talat Ali,1972-1979,10,16,4,4,0,0,4,1 (1ct 0st),0.25,PAK,1972,1979
1538,DJ Terbrugge,1998-2004,7,14,4,4,0,0,4,1 (1ct 0st),0.285,SA,1998,2004
1539,ERH Toshack,1946-1948,12,24,4,4,0,0,4,1 (1ct 0st),0.166,AUS,1946,1948
1540,CT Tremlett,2007-2013,12,24,4,4,0,0,4,1 (1ct 0st),0.166,ENG,2007,2013
1541,AE Trott,1895-1899,5,10,4,4,0,0,4,3 (3ct 0st),0.4,AUS/ENG,1895,1899
1542,FH Tyson,1954-1959,17,32,4,4,0,0,4,1 (1ct 0st),0.125,ENG,1954,1959
1543,JTC Vaughan,1992-1997,6,9,4,4,0,0,4,2 (2ct 0st),0.444,NZ,1992,1997
1544,HG Vivian,1931-1937,7,11,4,4,0,0,4,1 (1ct 0st),0.363,NZ,1931,1937
1545,HF Wade,1935-1936,10,15,4,4,0,0,4,1 (1ct 0st),0.266,SA,1935,1936
1546,W Watson,1986-1993,15,26,4,4,0,0,4,1 (1ct 0st),0.153,NZ,1986,1993
1547,WJ Whitty,1909-1912,14,25,4,4,0,0,4,1 (1ct 0st),0.16,AUS,1909,1912
1548,JM Wiener,1979-1980,6,10,4,4,0,0,4,2 (2ct 0st),0.4,AUS,1979,1980
1549,BA Williams,2003-2004,4,8,4,4,0,0,4,2 (2ct 0st),0.5,AUS,2003,2004
1550,DNT Zoysa,1997-2004,30,51,4,4,0,0,4,1 (1ct 0st),0.078,SL,1997,2004
1551,Zubayr Hamza,2019-2019,3,5,4,4,0,0,4,2 (2ct 0st),0.8,SA,2019,2019
1552,JW Zulch,1910-1921,16,30,4,4,0,0,4,1 (1ct 0st),0.133,SA,1910,1921
1553,Zulfiqar Babar,2013-2016,15,28,4,4,0,0,4,1 (1ct 0st),0.142,PAK,2013,2016
1554,Abul Hasan,2012-2013,3,6,3,3,0,0,3,2 (2ct 0st),0.5,BDESH,2012,2013
1555,Aftab Gul,1969-1971,6,11,3,3,0,0,3,1 (1ct 0st),0.272,PAK,1969,1971
1556,Agha Saadat Ali,1955-1955,1,2,3,3,0,0,3,2 (2ct 0st),1.5,PAK,1955,1955
1557,Ahmed Shehzad,2013-2017,13,26,3,3,0,0,3,1 (1ct 0st),0.115,PAK,2013,2017
1558,Akram Khan,2000-2003,8,11,3,3,0,0,3,1 (1ct 0st),0.272,BDESH,2000,2003
1559,CFW Allcott,1930-1932,6,9,3,3,0,0,3,1 (1ct 0st),0.3329999999999999,NZ,1930,1932
1560,L Amar Singh,1932-1936,7,13,3,3,0,0,3,1 (1ct 0st),0.23,INDIA,1932,1936
1561,AMJG Amerasinghe,1984-1984,2,3,3,3,0,0,3,2 (2ct 0st),1.0,SL,1984,1984
1562,BJ Arnel,2010-2012,6,12,3,3,0,0,3,1 (1ct 0st),0.25,NZ,2010,2012
1563,RA Austin,2009-2009,2,4,3,3,0,0,3,2 (2ct 0st),0.75,WI,2009,2009
1564,KBJ Azad,1981-1983,7,14,3,3,0,0,3,1 (1ct 0st),0.214,INDIA,1981,1983
1565,CL Badcock,1936-1938,7,11,3,3,0,0,3,1 (1ct 0st),0.272,AUS,1936,1938
1566,AH Bakewell,1931-1935,6,12,3,3,0,0,3,2 (2ct 0st),0.25,ENG,1931,1935
1567,A Balbirnie,2018-2019,3,6,3,3,0,0,3,1 (1ct 0st),0.5,IRE,2018,2019
1568,SA Banerjee,1948-1949,1,2,3,3,0,0,3,2 (2ct 0st),1.5,INDIA,1948,1949
1569,GJ Batty,2003-2016,9,16,3,3,0,0,3,2 (2ct 0st),0.187,ENG,2003,2016
1570,GP Bilby,1966-1966,2,3,3,3,0,0,3,1 (1ct 0st),1.0,NZ,1966,1966
1571,J Birkenshaw,1973-1974,5,9,3,3,0,0,3,2 (2ct 0st),0.3329999999999999,ENG,1973,1974
1572,M Bisset,1899-1910,3,6,3,2,1,2,0,1 (1ct 0st),0.5,SA,1899,1910
1573,TA Blundell,2017-2019,3,6,3,3,0,2,1,1 (1ct 0st),0.5,NZ,2017,2019
1574,J Botha,2006-2010,5,10,3,3,0,0,3,1 (1ct 0st),0.3,SA,2006,2010
1575,IDR Bradshaw,2006-2006,5,7,3,3,0,0,3,2 (2ct 0st),0.428,WI,2006,2006
1576,VR Brown,1985-1985,2,4,3,3,0,0,3,2 (2ct 0st),0.75,NZ,1985,1985
1577,JJ Bumrah,2018-2019,12,24,3,3,0,0,3,1 (1ct 0st),0.125,INDIA,2018,2019
1578,RO Butcher,1981-1981,3,4,3,3,0,0,3,2 (2ct 0st),0.75,ENG,1981,1981
1579,Hon.FSG Calthorpe,1930-1930,4,8,3,3,0,0,3,1 (1ct 0st),0.375,ENG,1930,1930
1580,PR Carlstein,1958-1964,8,15,3,3,0,0,3,1 (1ct 0st),0.2,SA,1958,1964
1581,AW Carr,1922-1929,11,16,3,3,0,0,3,1 (1ct 0st),0.187,ENG,1922,1929
1582,JAJ Christy,1929-1932,10,17,3,3,0,0,3,1 (1ct 0st),0.176,SA,1929,1932
1583,CK Coventry,2005-2005,2,3,3,3,0,0,3,2 (2ct 0st),1.0,ZIM,2005,2005
1584,J Cowie,1937-1949,9,14,3,3,0,0,3,2 (2ct 0st),0.214,NZ,1937,1949
1585,K Cranston,1947-1948,8,16,3,3,0,0,3,2 (2ct 0st),0.187,ENG,1947,1948
1586,RJ Crisp,1935-1936,9,14,3,3,0,0,3,1 (1ct 0st),0.214,SA,1935,1936
1587,CD Cumming,2005-2008,11,20,3,3,0,0,3,1 (1ct 0st),0.15,NZ,2005,2008
1588,TS Curtis,1988-1989,5,9,3,3,0,0,3,1 (1ct 0st),0.3329999999999999,ENG,1988,1989
1589,RKJ Dawson,2001-2003,7,11,3,3,0,0,3,2 (2ct 0st),0.272,ENG,2001,2003
1590,JH de Courcy,1953-1953,3,5,3,3,0,0,3,2 (2ct 0st),0.6,AUS,1953,1953
1591,GR Dickinson,1930-1932,3,6,3,3,0,0,3,2 (2ct 0st),0.5,NZ,1930,1932
1592,GHG Doggart,1950-1950,2,4,3,3,0,0,3,1 (1ct 0st),0.75,ENG,1950,1950
1593,B Dooland,1947-1948,3,6,3,3,0,0,3,1 (1ct 0st),0.5,AUS,1947,1948
1594,UG Dowe,1971-1973,4,8,3,3,0,0,3,1 (1ct 0st),0.375,WI,1971,1973
1595,A D'Souza,1959-1962,6,10,3,3,0,0,3,2 (2ct 0st),0.3,PAK,1959,1962
1596,CAR Duckworth,1957-1957,2,4,3,3,0,0,3,1 (1ct 0st),0.75,SA,1957,1957
1597,R Dumbrill,1965-1967,5,10,3,3,0,0,3,1 (1ct 0st),0.3,SA,1965,1967
1598,Enamul Haque jnr,2003-2013,15,27,3,3,0,0,3,1 (1ct 0st),0.111,BDESH,2003,2013
1599,Fakhar Zaman,2018-2019,3,6,3,3,0,0,3,1 (1ct 0st),0.5,PAK,2018,2019
1600,Fawad Alam,2009-2009,3,6,3,3,0,0,3,1 (1ct 0st),0.5,PAK,2009,2009
1601,BOP Fernando,2019-2019,4,7,3,3,0,0,3,1 (1ct 0st),0.428,SL,2019,2019
1602,MLC Foster,1969-1978,14,26,3,3,0,0,3,1 (1ct 0st),0.115,WI,1969,1978
1603,ERH Fuller,1953-1958,7,12,3,3,0,0,3,1 (1ct 0st),0.25,SA,1953,1958
1604,DJ Gandhi,1999-1999,4,8,3,3,0,0,3,1 (1ct 0st),0.375,INDIA,1999,1999
1605,JB Gannon,1977-1978,3,5,3,3,0,0,3,2 (2ct 0st),0.6,AUS,1977,1978
1606,AER Gilligan,1922-1925,11,21,3,3,0,0,3,1 (1ct 0st),0.142,ENG,1922,1925
1607,TWJ Goddard,1930-1939,8,13,3,3,0,0,3,1 (1ct 0st),0.23,ENG,1930,1939
1608,MJ Gopalan,1934-1934,1,2,3,3,0,0,3,2 (2ct 0st),1.5,INDIA,1934,1934
1609,H Graham,1893-1896,6,11,3,3,0,0,3,1 (1ct 0st),0.272,AUS,1893,1896
1610,GA Greenidge,1972-1973,5,9,3,3,0,0,3,1 (1ct 0st),0.3329999999999999,WI,1972,1973
1611,Gul Mohammad,1946-1956,9,13,3,3,0,0,3,1 (1ct 0st),0.23,INDIA/PAK,1946,1956
1612,JR Gunn,1901-1905,6,12,3,3,0,0,3,1 (1ct 0st),0.25,ENG,1901,1905
1613,PAM Hands,1913-1924,7,10,3,3,0,0,3,2 (2ct 0st),0.3,SA,1913,1924
1614,MS Hardikar,1958-1958,2,4,3,3,0,0,3,2 (2ct 0st),0.75,INDIA,1958,1958
1615,NM Hauritz,2004-2010,17,33,3,3,0,0,3,1 (1ct 0st),0.09,AUS,2004,2010
1616,Lord Hawke,1896-1899,5,10,3,3,0,0,3,2 (2ct 0st),0.3,ENG,1896,1899
1617,JA Hayes,1951-1958,15,20,3,3,0,0,3,2 (2ct 0st),0.15,NZ,1951,1958
1618,F Hearne,1889-1896,6,9,3,3,0,0,3,1 (1ct 0st),0.3329999999999999,ENG/SA,1889,1896
1619,GAL Hearne,1922-1924,3,5,3,3,0,0,3,3 (3ct 0st),0.6,SA,1922,1924
1620,C Heseltine,1896-1896,2,4,3,3,0,0,3,1 (1ct 0st),0.75,ENG,1896,1896
1621,JD Higgs,1978-1981,22,39,3,3,0,0,3,1 (1ct 0st),0.076,AUS,1978,1981
1622,DD Hindlekar,1936-1946,4,7,3,3,0,3,0,1 (1ct 0st),0.428,INDIA,1936,1946
1623,TV Hohns,1989-1989,7,13,3,3,0,0,3,1 (1ct 0st),0.23,AUS,1989,1989
1624,P Holmes,1921-1932,7,14,3,3,0,0,3,2 (2ct 0st),0.214,ENG,1921,1932
1625,KA Hope,2017-2017,5,9,3,3,0,0,3,1 (1ct 0st),0.3329999999999999,WI,2017,2017
1626,PA Horne,1987-1990,4,7,3,3,0,0,3,1 (1ct 0st),0.428,NZ,1987,1990
1627,AG Huckle,1997-1998,8,14,3,3,0,0,3,1 (1ct 0st),0.214,ZIM,1997,1998
1628,AG Hurst,1974-1979,12,22,3,3,0,0,3,1 (1ct 0st),0.136,AUS,1974,1979
1629,P Hutchinson,1889-1889,2,3,3,3,0,0,3,2 (2ct 0st),1.0,SA,1889,1889
1630,Ijaz Ahmed jnr,1995-1995,2,4,3,3,0,0,3,2 (2ct 0st),0.75,PAK,1995,1995
1631,JK Irani,1947-1947,2,2,3,2,1,2,0,2 (1ct 1st),1.5,INDIA,1947,1947
1632,H Ironmonger,1928-1933,14,28,3,3,0,0,3,2 (2ct 0st),0.107,AUS,1928,1933
1633,KM Jarvis,2011-2018,12,21,3,3,0,0,3,1 (1ct 0st),0.142,ZIM,2011,2018
1634,TW Jarvis,1965-1973,13,24,3,3,0,0,3,2 (2ct 0st),0.125,NZ,1965,1973
1635,CEL Jones,1930-1935,4,8,3,3,0,0,3,2 (2ct 0st),0.375,WI,1930,1935
1636,SC Joseph,2004-2007,5,9,3,3,0,0,3,1 (1ct 0st),0.3329999999999999,WI,2004,2007
1637,PHT Kaushal,2014-2015,7,14,3,3,0,0,3,2 (2ct 0st),0.214,SL,2014,2015
1638,JM Kemp,2001-2005,4,8,3,3,0,0,3,1 (1ct 0st),0.375,SA,2001,2005
1639,Khalid Ibadulla,1964-1967,4,8,3,3,0,0,3,2 (2ct 0st),0.375,PAK,1964,1967
1640,RJ Kirtley,2003-2003,4,7,3,3,0,0,3,1 (1ct 0st),0.428,ENG,2003,2003
1641,JJ Kotze,1902-1907,3,5,3,3,0,0,3,1 (1ct 0st),0.6,SA,1902,1907
1642,Kuldeep Yadav,2017-2019,6,11,3,3,0,0,3,1 (1ct 0st),0.272,INDIA,2017,2019
1643,GF Labrooy,1986-1991,9,15,3,3,0,0,3,1 (1ct 0st),0.2,SL,1986,1991
1644,TJ Laughlin,1978-1978,3,6,3,3,0,0,3,2 (2ct 0st),0.5,AUS,1978,1978
1645,JJC Lawson,2002-2005,13,26,3,3,0,0,3,1 (1ct 0st),0.115,WI,2002,2005
1646,E Leadbeater,1951-1952,2,4,3,3,0,0,3,2 (2ct 0st),0.75,ENG,1951,1952
1647,WHV Levett,1934-1934,1,2,3,3,0,3,0,3 (3ct 0st),1.5,ENG,1934,1934
1648,HSB Love,1933-1933,1,2,3,3,0,3,0,3 (3ct 0st),1.5,AUS,1933,1933
1649,JJ Lyons,1887-1897,14,25,3,3,0,0,3,1 (1ct 0st),0.12,AUS,1887,1897
1650,EA McDonald,1921-1921,11,22,3,3,0,0,3,1 (1ct 0st),0.136,AUS,1921,1921
1651,A McGrath,2003-2003,4,7,3,3,0,0,3,1 (1ct 0st),0.428,ENG,2003,2003
1652,RW McLeod,1892-1893,6,10,3,3,0,0,3,1 (1ct 0st),0.3,AUS,1892,1893
1653,ES Maka,1952-1953,2,3,3,2,1,2,0,3 (2ct 1st),1.0,INDIA,1952,1953
1654,FG Mann,1948-1949,7,13,3,3,0,0,3,2 (2ct 0st),0.23,ENG,1948,1949
1655,NBF Mann,1947-1951,19,34,3,3,0,0,3,1 (1ct 0st),0.088,SA,1947,1951
1656,GA Manou,2009-2009,1,1,3,3,0,3,0,3 (3ct 0st),3.0,AUS,2009,2009
1657,Manjural Islam Rana,2004-2004,6,7,3,3,0,0,3,2 (2ct 0st),0.428,BDESH,2004,2004
1658,JR Mason,1897-1898,5,8,3,3,0,0,3,1 (1ct 0st),0.375,ENG,1897,1898
1659,EH Mattis,1981-1981,4,8,3,3,0,0,3,2 (2ct 0st),0.375,WI,1981,1981
1660,B Mavuta,2018-2018,2,4,3,3,0,0,3,2 (2ct 0st),0.75,ZIM,2018,2018
1661,MP Maynard,1988-1994,4,8,3,3,0,0,3,1 (1ct 0st),0.375,ENG,1988,1994
1662,LC Mayne,1965-1970,6,12,3,3,0,0,3,1 (1ct 0st),0.25,AUS,1965,1970
1663,DJ Meintjes,1923-1923,2,4,3,3,0,0,3,2 (2ct 0st),0.75,SA,1923,1923
1664,RS Modi,1946-1952,10,16,3,3,0,0,3,1 (1ct 0st),0.187,INDIA,1946,1952
1665,Mohammad Asif,2005-2010,23,45,3,3,0,0,3,1 (1ct 0st),0.066,PAK,2005,2010
1666,Mohammad Salman,2011-2011,2,4,3,2,1,2,0,1 (1ct 0st),0.75,PAK,2011,2011
1667,DAR Moloney,1937-1937,3,6,3,3,0,0,3,2 (2ct 0st),0.5,NZ,1937,1937
1668,H Morris,1991-1991,3,6,3,3,0,0,3,1 (1ct 0st),0.5,ENG,1991,1991
1669,JE Morris,1990-1990,3,5,3,3,0,0,3,2 (2ct 0st),0.6,ENG,1990,1990
1670,JB Mortimore,1959-1964,9,17,3,3,0,0,3,1 (1ct 0st),0.176,ENG,1959,1964
1671,ARA Murray,1952-1954,10,18,3,3,0,0,3,1 (1ct 0st),0.166,SA,1952,1954
1672,Naved-ul-Hasan,2004-2007,9,17,3,3,0,0,3,2 (2ct 0st),0.176,PAK,2004,2007
1673,CS Nayudu,1934-1952,11,17,3,3,0,0,3,1 (1ct 0st),0.176,INDIA,1934,1952
1674,C Newberry,1913-1914,4,7,3,3,0,0,3,3 (3ct 0st),0.428,SA,1913,1914
1675,ES Newson,1930-1939,3,6,3,3,0,0,3,2 (2ct 0st),0.5,SA,1930,1939
1676,L Ngidi,2018-2019,5,9,3,3,0,0,3,1 (1ct 0st),0.3329999999999999,SA,2018,2019
1677,F Nicholson,1935-1936,4,6,3,3,0,3,0,2 (2ct 0st),0.5,SA,1935,1936
1678,HC Nitschke,1931-1931,2,4,3,3,0,0,3,1 (1ct 0st),0.75,AUS,1931,1931
1679,LPJ O'Brien,1932-1936,5,9,3,3,0,0,3,2 (2ct 0st),0.3329999999999999,AUS,1932,1936
1680,JDA O'Connor,1908-1909,4,8,3,3,0,0,3,1 (1ct 0st),0.375,AUS,1908,1909
1681,MB Owens,1992-1994,8,12,3,3,0,0,3,2 (2ct 0st),0.25,NZ,1992,1994
1682,T Panyangara,2004-2014,9,16,3,3,0,0,3,2 (2ct 0st),0.187,ZIM,2004,2014
1683,WGA Parkhouse,1950-1959,7,13,3,3,0,0,3,1 (1ct 0st),0.23,ENG,1950,1959
1684,CH Parkin,1920-1924,10,17,3,3,0,0,3,2 (2ct 0st),0.176,ENG,1920,1924
1685,WD Parnell,2010-2017,6,11,3,3,0,0,3,1 (1ct 0st),0.272,SA,2010,2017
1686,CC Passailaigue,1930-1930,1,2,3,3,0,0,3,2 (2ct 0st),1.5,WI,1930,1930
1687,SR Patel,2012-2015,6,12,3,3,0,0,3,1 (1ct 0st),0.25,ENG,2012,2015
1688,AJ Pithey,1957-1965,17,32,3,3,0,0,3,1 (1ct 0st),0.093,SA,1957,1965
1689,LE Plunkett,2005-2014,13,25,3,3,0,0,3,1 (1ct 0st),0.12,ENG,2005,2014
1690,R Pollard,1946-1948,4,7,3,3,0,0,3,1 (1ct 0st),0.428,ENG,1946,1948
1691,RM Poore,1896-1896,3,4,3,3,0,0,3,2 (2ct 0st),0.75,SA,1896,1896
1692,SW Poynter,2019-2019,1,2,3,2,1,2,0,2 (1ct 1st),1.5,IRE,2019,2019
1693,C Pringle,1990-1995,14,24,3,3,0,0,3,1 (1ct 0st),0.125,NZ,1990,1995
1694,R Rampaul,2009-2012,18,34,3,3,0,0,3,1 (1ct 0st),0.088,WI,2009,2012
1695,BA Richards,1970-1970,4,8,3,3,0,0,3,1 (1ct 0st),0.375,SA,1970,1970
1696,F Ridgway,1951-1952,5,8,3,3,0,0,3,2 (2ct 0st),0.375,ENG,1951,1952
1697,WV Rodriguez,1962-1968,5,10,3,3,0,0,3,2 (2ct 0st),0.3,WI,1962,1968
1698,Sabbir Rahman,2016-2018,11,21,3,3,0,0,3,2 (2ct 0st),0.142,BDESH,2016,2018
1699,Salahuddin,1965-1969,5,9,3,3,0,0,3,1 (1ct 0st),0.3329999999999999,PAK,1965,1969
1700,Saleem Altaf,1967-1978,21,41,3,3,0,0,3,1 (1ct 0st),0.073,PAK,1967,1978
1701,MAR Samarasekera,1988-1991,4,6,3,3,0,0,3,2 (2ct 0st),0.5,SL,1988,1991
1702,Shabbir Ahmed,2003-2005,10,19,3,3,0,0,3,1 (1ct 0st),0.157,PAK,2003,2005
1703,Shadman Islam,2018-2019,6,8,3,3,0,0,3,2 (2ct 0st),0.375,BDESH,2018,2019
1704,WA Shalders,1899-1907,12,23,3,3,0,0,3,1 (1ct 0st),0.13,SA,1899,1907
1705,DP Sibley,2019-2019,3,5,3,3,0,0,3,1 (1ct 0st),0.6,ENG,2019,2019
1706,TAM Siriwardana,2015-2016,5,10,3,3,0,0,3,1 (1ct 0st),0.3,SL,2015,2016
1707,WN Slack,1986-1986,3,6,3,3,0,0,3,1 (1ct 0st),0.5,ENG,1986,1986
1708,JA Small,1928-1930,3,4,3,3,0,0,3,2 (2ct 0st),0.75,WI,1928,1930
1709,VI Smith,1947-1957,9,16,3,3,0,0,3,1 (1ct 0st),0.187,SA,1947,1957
1710,JT Sparling,1958-1964,11,16,3,3,0,0,3,1 (1ct 0st),0.187,NZ,1958,1964
1711,LA Stricker,1910-1912,13,24,3,3,0,0,3,1 (1ct 0st),0.125,SA,1910,1912
1712,Tahir Naqqash,1982-1985,15,27,3,3,0,0,3,1 (1ct 0st),0.111,PAK,1982,1985
1713,LJ Tancred,1902-1913,14,26,3,3,0,0,3,1 (1ct 0st),0.115,SA,1902,1913
1714,G Thomas,1965-1966,8,15,3,3,0,0,3,1 (1ct 0st),0.2,AUS,1965,1966
1715,NFD Thomson,1877-1877,2,4,3,3,0,0,3,2 (2ct 0st),0.75,AUS,1877,1877
1716,NI Thomson,1964-1965,5,10,3,3,0,0,3,1 (1ct 0st),0.3,ENG,1964,1965
1717,T Thushara,2003-2010,10,18,3,3,0,0,3,2 (2ct 0st),0.166,SL,2003,2010
1718,JW Trumble,1885-1886,7,11,3,3,0,0,3,2 (2ct 0st),0.272,AUS,1885,1886
1719,AJ Tudor,1998-2002,10,17,3,3,0,0,3,2 (2ct 0st),0.176,ENG,1998,2002
1720,EA van der Merwe,1929-1936,2,3,3,3,0,3,0,2 (2ct 0st),1.0,SA,1929,1936
1721,R Vijay Bharadwaj,1999-2000,3,5,3,3,0,0,3,2 (2ct 0st),0.6,INDIA,1999,2000
1722,GE Vivian,1965-1972,5,10,3,3,0,0,3,1 (1ct 0st),0.3,NZ,1965,1972
1723,KA Walter,1961-1961,2,4,3,3,0,0,3,1 (1ct 0st),0.75,SA,1961,1961
1724,A Ward,1969-1976,5,9,3,3,0,0,3,2 (2ct 0st),0.3329999999999999,ENG,1969,1976
1725,PF Warner,1899-1912,15,28,3,3,0,0,3,2 (2ct 0st),0.107,ENG,1899,1912
1726,JA Warrican,2015-2019,8,13,3,3,0,0,3,1 (1ct 0st),0.23,WI,2015,2019
1727,DM Washington,2005-2005,1,2,3,3,0,0,3,2 (2ct 0st),1.5,WI,2005,2005
1728,GL Weir,1930-1937,11,16,3,3,0,0,3,1 (1ct 0st),0.187,NZ,1930,1937
1729,P Willey,1976-1986,26,44,3,3,0,0,3,1 (1ct 0st),0.068,ENG,1976,1986
1730,H Wood,1888-1892,4,8,3,2,1,2,0,2 (1ct 1st),0.375,ENG,1888,1892
1731,OE Wynne,1948-1950,6,10,3,3,0,0,3,2 (2ct 0st),0.3,SA,1948,1950
1732,V Yadav,1993-1993,1,2,3,1,2,1,0,2 (0ct 2st),1.5,INDIA,1993,1993
1733,Aamer Nazir,1993-1995,6,12,2,2,0,0,2,2 (2ct 0st),0.166,PAK,1993,1995
1734,Aaqib Javed,1989-1998,22,38,2,2,0,0,2,1 (1ct 0st),0.052,PAK,1989,1998
1735,Afaq Hussain,1961-1964,2,4,2,2,0,0,2,1 (1ct 0st),0.5,PAK,1961,1964
1736,G Alexander,1880-1884,2,4,2,2,0,0,2,1 (1ct 0st),0.5,AUS,1880,1884
1737,RC Allen,1887-1887,1,2,2,2,0,0,2,2 (2ct 0st),1.0,AUS,1887,1887
1738,GI Allott,1996-1999,10,16,2,2,0,0,2,1 (1ct 0st),0.125,NZ,1996,1999
1739,SW Ambris,2017-2018,6,9,2,2,0,0,2,1 (1ct 0st),0.222,WI,2017,2018
1740,Anamul Haque,2013-2014,4,7,2,2,0,0,2,1 (1ct 0st),0.285,BDESH,2013,2014
1741,ML Apte,1952-1953,7,12,2,2,0,0,2,1 (1ct 0st),0.166,INDIA,1952,1953
1742,Ariful Haque,2018-2018,2,4,2,2,0,0,2,1 (1ct 0st),0.5,BDESH,2018,2018
1743,Arshad Ayub,1987-1989,13,24,2,2,0,0,2,1 (1ct 0st),0.083,INDIA,1987,1989
1744,B Arun,1986-1987,2,3,2,2,0,0,2,1 (1ct 0st),0.6659999999999999,INDIA,1986,1987
1745,Asghar Afghan,2018-2019,4,7,2,2,0,0,2,1 (1ct 0st),0.285,AFG,2018,2019
1746,TD Astle,2012-2019,4,8,2,2,0,0,2,1 (1ct 0st),0.25,NZ,2012,2019
1747,Ata-ur-Rehman,1992-1996,13,23,2,2,0,0,2,1 (1ct 0st),0.086,PAK,1992,1996
1748,ES Atkinson,1958-1959,8,15,2,2,0,0,2,1 (1ct 0st),0.133,WI,1958,1959
1749,RA Austin,1978-1978,2,4,2,2,0,0,2,1 (1ct 0st),0.5,WI,1978,1978
1750,S Badrinath,2010-2010,2,3,2,2,0,0,2,1 (1ct 0st),0.6659999999999999,INDIA,2010,2010
1751,L Baichan,1975-1976,3,6,2,2,0,0,2,2 (2ct 0st),0.3329999999999999,WI,1975,1976
1752,EAE Baptiste,1983-1990,10,20,2,2,0,0,2,1 (1ct 0st),0.1,WI,1983,1990
1753,F Barratt,1929-1930,5,8,2,2,0,0,2,1 (1ct 0st),0.25,ENG,1929,1930
1754,EL Bartlett,1928-1931,5,7,2,2,0,0,2,1 (1ct 0st),0.285,WI,1928,1931
1755,Bazid Khan,2005-2005,1,2,2,2,0,0,2,2 (2ct 0st),1.0,PAK,2005,2005
1756,DD Beard,1952-1956,4,7,2,2,0,0,2,2 (2ct 0st),0.285,NZ,1952,1956
1757,R Beaumont,1912-1914,5,7,2,2,0,0,2,1 (1ct 0st),0.285,SA,1912,1914
1758,DW Begbie,1948-1950,5,8,2,2,0,0,2,1 (1ct 0st),0.25,SA,1948,1950
1759,KCG Benjamin,1992-1998,26,50,2,2,0,0,2,1 (1ct 0st),0.04,WI,1992,1998
1760,R Berry,1950-1950,2,4,2,2,0,0,2,2 (2ct 0st),0.5,ENG,1950,1950
1761,MP Bicknell,1993-2003,4,7,2,2,0,0,2,1 (1ct 0st),0.285,ENG,1993,2003
1762,Bilal Asif,2018-2018,5,10,2,2,0,0,2,2 (2ct 0st),0.2,PAK,2018,2018
1763,JM Bird,2012-2017,9,17,2,2,0,0,2,1 (1ct 0st),0.1169999999999999,AUS,2012,2017
1764,DD Blackie,1928-1929,3,6,2,2,0,0,2,2 (2ct 0st),0.3329999999999999,AUS,1928,1929
1765,RJ Blakey,1993-1993,2,2,2,2,0,2,0,1 (1ct 0st),1.0,ENG,1993,1993
1766,DE Bollinger,2009-2010,12,23,2,2,0,0,2,1 (1ct 0st),0.086,AUS,2009,2010
1767,JB Bolus,1963-1964,7,14,2,2,0,0,2,1 (1ct 0st),0.142,ENG,1963,1964
1768,SG Borthwick,2014-2014,1,2,2,2,0,0,2,2 (2ct 0st),1.0,ENG,2014,2014
1769,WE Bowes,1932-1946,15,29,2,2,0,0,2,1 (1ct 0st),0.068,ENG,1932,1946
1770,EH Bowley,1929-1930,5,8,2,2,0,0,2,1 (1ct 0st),0.25,ENG,1929,1930
1771,NW Bracken,2003-2005,5,10,2,2,0,0,2,1 (1ct 0st),0.2,AUS,2003,2005
1772,WP Bradburn,1964-1964,2,4,2,2,0,0,2,1 (1ct 0st),0.5,NZ,1964,1964
1773,WH Brann,1922-1923,3,6,2,2,0,0,2,1 (1ct 0st),0.3329999999999999,SA,1922,1923
1774,EH Bromley,1933-1934,2,3,2,2,0,0,2,1 (1ct 0st),0.6659999999999999,AUS,1933,1934
1775,CP Buckenham,1910-1910,4,8,2,2,0,0,2,1 (1ct 0st),0.25,ENG,1910,1910
1776,FJ Burton,1887-1888,2,4,2,1,1,0,1,1 (1ct 0st),0.5,AUS,1887,1888
1777,TB Burtt,1947-1953,10,14,2,2,0,0,2,1 (1ct 0st),0.142,NZ,1947,1953
1778,HR Butt,1896-1896,3,6,2,1,1,1,0,1 (1ct 0st),0.3329999999999999,ENG,1896,1896
1779,CG Butts,1985-1988,7,12,2,2,0,0,2,1 (1ct 0st),0.166,WI,1985,1988
1780,FJ Cameron,1961-1965,19,35,2,2,0,0,2,1 (1ct 0st),0.057,NZ,1961,1965
1781,J Cameron-Dow,2019-2019,1,2,2,2,0,0,2,2 (2ct 0st),1.0,IRE,2019,2019
1782,PH Carlson,1979-1979,2,4,2,2,0,0,2,1 (1ct 0st),0.5,AUS,1979,1979
1783,CP Carter,1912-1924,10,16,2,2,0,0,2,1 (1ct 0st),0.125,SA,1912,1924
1784,TW Cartwright,1964-1965,5,9,2,2,0,0,2,2 (2ct 0st),0.222,ENG,1964,1965
1785,B Casson,2008-2008,1,2,2,2,0,0,2,2 (2ct 0st),1.0,AUS,2008,2008
1786,R Chandrika,2015-2016,5,7,2,2,0,0,2,2 (2ct 0st),0.285,WI,2015,2016
1787,TM Chappell,1981-1981,3,6,2,2,0,0,2,1 (1ct 0st),0.3329999999999999,AUS,1981,1981
1788,ST Clarke,1978-1982,11,19,2,2,0,0,2,1 (1ct 0st),0.105,WI,1978,1982
1789,SHM Colah,1932-1933,2,4,2,2,0,0,2,2 (2ct 0st),0.5,INDIA,1932,1933
1790,JB Commins,1994-1995,3,6,2,2,0,0,2,1 (1ct 0st),0.3329999999999999,SA,1994,1995
1791,BB Cooper,1877-1877,1,2,2,2,0,0,2,2 (2ct 0st),1.0,AUS,1877,1877
1792,TA Copeland,2011-2011,3,6,2,2,0,0,2,1 (1ct 0st),0.3329999999999999,AUS,2011,2011
1793,RMH Cottam,1969-1973,4,8,2,2,0,0,2,1 (1ct 0st),0.25,ENG,1969,1973
1794,ID Craig,1953-1958,11,20,2,2,0,0,2,1 (1ct 0st),0.1,AUS,1953,1958
1795,ML Cummins,2016-2019,14,23,2,2,0,0,2,1 (1ct 0st),0.086,WI,2016,2019
1796,SM Curran,2018-2019,14,27,2,2,0,0,2,2 (2ct 0st),0.074,ENG,2018,2019
1797,WR Cuttell,1899-1899,2,4,2,2,0,0,2,2 (2ct 0st),0.5,ENG,1899,1899
1798,LA Dawson,2016-2017,3,5,2,2,0,0,2,2 (2ct 0st),0.4,ENG,2016,2017
1799,H Dean,1912-1912,3,5,2,2,0,0,2,1 (1ct 0st),0.4,ENG,1912,1912
1800,CS Dempster,1930-1933,10,15,2,2,0,0,2,1 (1ct 0st),0.133,NZ,1930,1933
1801,XJ Doherty,2010-2013,4,6,2,2,0,0,2,2 (2ct 0st),0.3329999999999999,AUS,2010,2013
1802,H Donnan,1892-1896,5,9,2,2,0,0,2,1 (1ct 0st),0.222,AUS,1892,1896
1803,RR Dower,1899-1899,1,2,2,2,0,0,2,1 (1ct 0st),1.0,SA,1899,1899
1804,VC Drakes,2002-2004,12,23,2,2,0,0,2,1 (1ct 0st),0.086,WI,2002,2004
1805,JP Duminy,1927-1929,3,6,2,2,0,0,2,1 (1ct 0st),0.3329999999999999,SA,1927,1929
1806,JA Dunning,1933-1937,4,7,2,2,0,0,2,1 (1ct 0st),0.285,NZ,1933,1937
1807,JH du Preez,1967-1967,2,4,2,2,0,0,2,1 (1ct 0st),0.5,SA,1967,1967
1808,CJ Eady,1896-1902,2,4,2,2,0,0,2,1 (1ct 0st),0.5,AUS,1896,1902
1809,Ehteshamuddin,1979-1982,5,8,2,2,0,0,2,1 (1ct 0st),0.25,PAK,1979,1982
1810,GD Elliott,2008-2009,5,9,2,2,0,0,2,2 (2ct 0st),0.222,NZ,2008,2009
1811,RM Ellison,1984-1986,11,22,2,2,0,0,2,1 (1ct 0st),0.09,ENG,1984,1986
1812,SH Emery,1912-1912,4,5,2,2,0,0,2,1 (1ct 0st),0.4,AUS,1912,1912
1813,WS Farrer,1962-1964,6,12,2,2,0,0,2,1 (1ct 0st),0.166,SA,1962,1964
1814,Fazl-e-Akbar,1998-2004,5,8,2,2,0,0,2,1 (1ct 0st),0.25,PAK,1998,2004
1815,JP Fellows-Smith,1960-1960,4,7,2,2,0,0,2,1 (1ct 0st),0.285,SA,1960,1960
1816,MVT Fernando,2016-2019,7,12,2,2,0,0,2,1 (1ct 0st),0.166,SL,2016,2019
1817,CG Fichardt,1892-1896,2,3,2,2,0,0,2,1 (1ct 0st),0.6659999999999999,SA,1892,1896
1818,W Flowers,1884-1893,8,15,2,2,0,0,2,1 (1ct 0st),0.133,ENG,1884,1893
1819,TJ Friend,2001-2004,13,19,2,2,0,0,2,1 (1ct 0st),0.105,ZIM,2001,2004
1820,LV Garrick,2001-2001,1,2,2,2,0,0,2,1 (1ct 0st),1.0,WI,2001,2001
1821,C Gladwin,1947-1949,8,15,2,2,0,0,2,1 (1ct 0st),0.133,ENG,1947,1949
1822,RA Gleeson,1896-1896,1,2,2,2,0,0,2,1 (1ct 0st),1.0,SA,1896,1896
1823,CD Gopinath,1951-1960,8,14,2,2,0,0,2,1 (1ct 0st),0.142,INDIA,1951,1960
1824,GF Grace,1880-1880,1,2,2,2,0,0,2,2 (2ct 0st),1.0,ENG,1880,1880
1825,R Graham,1899-1899,2,4,2,2,0,0,2,2 (2ct 0st),0.5,SA,1899,1899
1826,A Greenwood,1877-1877,2,4,2,2,0,0,2,1 (1ct 0st),0.5,ENG,1877,1877
1827,GM Guard,1958-1960,2,4,2,2,0,0,2,2 (2ct 0st),0.5,INDIA,1958,1960
1828,S Guha,1967-1969,4,8,2,2,0,0,2,1 (1ct 0st),0.25,INDIA,1967,1969
1829,DA Gunawardene,1999-2005,6,9,2,2,0,0,2,1 (1ct 0st),0.222,SL,1999,2005
1830,Gursharan Singh,1990-1990,1,2,2,2,0,0,2,1 (1ct 0st),1.0,INDIA,1990,1990
1831,JW Guy,1955-1961,12,15,2,2,0,0,2,1 (1ct 0st),0.133,NZ,1955,1961
1832,JR Hammond,1973-1973,5,10,2,2,0,0,2,2 (2ct 0st),0.2,AUS,1973,1973
1833,Lord Harris,1879-1884,4,7,2,2,0,0,2,1 (1ct 0st),0.285,ENG,1879,1884
1834,JC Hartley,1906-1906,2,3,2,2,0,0,2,1 (1ct 0st),0.6659999999999999,ENG,1906,1906
1835,MJ Haslam,1992-1995,4,6,2,2,0,0,2,2 (2ct 0st),0.3329999999999999,NZ,1992,1995
1836,EG Hayes,1906-1912,5,10,2,2,0,0,2,1 (1ct 0st),0.2,ENG,1906,1912
1837,RGA Headley,1973-1973,2,4,2,2,0,0,2,1 (1ct 0st),0.5,WI,1973,1973
1838,CW Henderson,2001-2002,7,14,2,2,0,0,2,1 (1ct 0st),0.142,SA,2001,2002
1839,O Henry,1992-1993,3,5,2,2,0,0,2,2 (2ct 0st),0.4,SA,1992,1993
1840,JC Hill,1953-1955,3,5,2,2,0,0,2,1 (1ct 0st),0.4,AUS,1953,1955
1841,DE Hoare,1961-1961,1,2,2,2,0,0,2,1 (1ct 0st),1.0,AUS,1961,1961
1842,TG Hogan,1983-1984,7,11,2,2,0,0,2,1 (1ct 0st),0.181,AUS,1983,1984
1843,WE Hollies,1935-1950,13,23,2,2,0,0,2,1 (1ct 0st),0.086,ENG,1935,1950
1844,BC Hollioake,1997-1998,2,4,2,2,0,0,2,1 (1ct 0st),0.5,ENG,1997,1998
1845,L Hone,1879-1879,1,2,2,2,0,2,0,2 (2ct 0st),1.0,ENG,1879,1879
1846,MJ Horton,1959-1959,2,4,2,2,0,0,2,1 (1ct 0st),0.5,ENG,1959,1959
1847,R Howorth,1947-1948,5,10,2,2,0,0,2,1 (1ct 0st),0.2,ENG,1947,1948
1848,A Hurwood,1930-1931,2,4,2,2,0,0,2,2 (2ct 0st),0.5,AUS,1930,1931
1849,RC Irani,1996-1999,3,5,2,2,0,0,2,2 (2ct 0st),0.4,ENG,1996,1999
1850,Irfan Fazil,2000-2000,1,2,2,2,0,0,2,1 (1ct 0st),1.0,PAK,2000,2000
1851,BL Irvine,1970-1970,4,8,2,2,0,0,2,1 (1ct 0st),0.25,SA,1970,1970
1852,JB Iverson,1950-1951,5,10,2,2,0,0,2,1 (1ct 0st),0.2,AUS,1950,1951
1853,RJD Jamshedji,1933-1933,1,2,2,2,0,0,2,2 (2ct 0st),1.0,INDIA,1933,1933
1854,MP Jarvis,1992-1994,5,8,2,2,0,0,2,1 (1ct 0st),0.25,ZIM,1992,1994
1855,PW Jarvis,1988-1993,9,16,2,2,0,0,2,1 (1ct 0st),0.125,ENG,1988,1993
1856,MDUS Jayasundera,2015-2015,2,4,2,2,0,0,2,1 (1ct 0st),0.5,SL,2015,2015
1857,VB John,1983-1984,6,9,2,2,0,0,2,1 (1ct 0st),0.222,SL,1983,1984
1858,LJ Johnson,1948-1948,1,2,2,2,0,0,2,2 (2ct 0st),1.0,AUS,1948,1948
1859,Jubair Hossain,2014-2015,6,9,2,2,0,0,2,1 (1ct 0st),0.222,BDESH,2014,2015
1860,H Jupp,1877-1877,2,4,2,2,0,0,2,2 (2ct 0st),0.5,ENG,1877,1877
1861,BR Jurangpathy,1985-1986,2,3,2,2,0,0,2,2 (2ct 0st),0.6659999999999999,SL,1985,1986
1862,S Kalavitigoda,2005-2005,1,1,2,2,0,0,2,2 (2ct 0st),2.0,SL,2005,2005
1863,LWS Kaluperuma,1982-1982,2,4,2,2,0,0,2,2 (2ct 0st),0.5,SL,1982,1982
1864,M Kartik,2000-2004,8,15,2,2,0,0,2,1 (1ct 0st),0.133,INDIA,2000,2004
1865,TK Kendall,1877-1877,2,4,2,2,0,0,2,1 (1ct 0st),0.5,AUS,1877,1877
1866,RJ Kennedy,1996-1996,4,8,2,2,0,0,2,1 (1ct 0st),0.25,NZ,1996,1996
1867,Khaled Mahmud,2001-2003,12,17,2,2,0,0,2,1 (1ct 0st),0.1169999999999999,BDESH,2001,2003
1868,ET Killick,1929-1929,2,4,2,2,0,0,2,1 (1ct 0st),0.5,ENG,1929,1929
1869,LA King,1962-1968,2,4,2,2,0,0,2,1 (1ct 0st),0.5,WI,1962,1968
1870,RD King,1999-2005,19,34,2,2,0,0,2,1 (1ct 0st),0.0579999999999999,WI,1999,2005
1871,RK Kleinveldt,2012-2013,4,7,2,2,0,0,2,1 (1ct 0st),0.285,SA,2012,2013
1872,P Kumar,2011-2011,6,11,2,2,0,0,2,2 (2ct 0st),0.181,INDIA,2011,2011
1873,VV Kumar,1961-1961,2,4,2,2,0,0,2,1 (1ct 0st),0.5,INDIA,1961,1961
1874,GA Lamb,2011-2011,1,2,2,2,0,0,2,1 (1ct 0st),1.0,ZIM,2011,2011
1875,CK Langeveldt,2005-2006,6,11,2,2,0,0,2,1 (1ct 0st),0.181,SA,2005,2006
1876,GB Lawrence,1961-1962,5,10,2,2,0,0,2,2 (2ct 0st),0.2,SA,1961,1962
1877,WS Lees,1906-1906,5,9,2,2,0,0,2,1 (1ct 0st),0.222,ENG,1906,1906
1878,IB Leggat,1954-1954,1,2,2,2,0,0,2,2 (2ct 0st),1.0,NZ,1954,1954
1879,PJ Loader,1954-1959,13,26,2,2,0,0,2,1 (1ct 0st),0.076,ENG,1954,1959
1880,Hon.A Lyttelton,1880-1884,4,7,2,2,0,2,0,1 (1ct 0st),0.285,ENG,1880,1884
1881,AB McDonald,2009-2009,4,7,2,2,0,0,2,1 (1ct 0st),0.285,AUS,2009,2009
1882,NC McGarrell,2001-2001,4,8,2,2,0,0,2,1 (1ct 0st),0.25,WI,2001,2001
1883,PG McShane,1885-1888,3,5,2,2,0,0,2,1 (1ct 0st),0.4,AUS,1885,1888
1884,NJ Maddinson,2016-2016,3,6,2,2,0,0,2,1 (1ct 0st),0.3329999999999999,AUS,2016,2016
1885,IS Madray,1958-1958,2,4,2,2,0,0,2,1 (1ct 0st),0.5,WI,1958,1958
1886,JN Maguire,1983-1984,3,5,2,2,0,0,2,2 (2ct 0st),0.4,AUS,1983,1984
1887,AO Malhotra,1982-1985,7,11,2,2,0,0,2,1 (1ct 0st),0.181,INDIA,1982,1985
1888,AL Mann,1977-1978,4,7,2,2,0,0,2,1 (1ct 0st),0.285,AUS,1977,1978
1889,DA Marillier,2000-2002,5,9,2,2,0,0,2,1 (1ct 0st),0.222,ZIM,2000,2002
1890,Marshall Ayub,2013-2014,3,4,2,2,0,0,2,1 (1ct 0st),0.5,BDESH,2013,2014
1891,F Martin,1890-1892,2,4,2,2,0,0,2,1 (1ct 0st),0.5,ENG,1890,1892
1892,FR Martin,1928-1931,9,12,2,2,0,0,2,1 (1ct 0st),0.166,WI,1928,1931
1893,SW Masakadza,2012-2014,5,9,2,2,0,0,2,1 (1ct 0st),0.222,ZIM,2012,2014
1894,AM Matheson,1930-1931,2,3,2,2,0,0,2,2 (2ct 0st),0.6659999999999999,NZ,1930,1931
1895,ER Mayne,1912-1921,4,7,2,2,0,0,2,2 (2ct 0st),0.285,AUS,1912,1921
1896,M Mbangwa,1996-2000,15,25,2,2,0,0,2,1 (1ct 0st),0.08,ZIM,1996,2000
1897,JA McCollum,2019-2019,2,4,2,2,0,0,2,1 (1ct 0st),0.5,IRE,2019,2019
1898,Mehrab Hossain jnr,2007-2009,7,11,2,2,0,0,2,1 (1ct 0st),0.181,BDESH,2007,2009
1899,BAW Mendis,2008-2014,19,31,2,2,0,0,2,1 (1ct 0st),0.064,SL,2008,2014
1900,WE Merritt,1930-1931,6,10,2,2,0,0,2,2 (2ct 0st),0.2,NZ,1930,1931
1901,AG Milkha Singh,1960-1961,4,7,2,2,0,0,2,1 (1ct 0st),0.285,INDIA,1960,1961
1902,WH Milton,1889-1892,3,4,2,2,0,0,2,1 (1ct 0st),0.5,SA,1889,1892
1903,F Mitchell,1899-1912,5,8,2,2,0,0,2,1 (1ct 0st),0.25,ENG/SA,1899,1912
1904,Mohammad Mithun,2018-2019,7,10,2,2,0,0,2,1 (1ct 0st),0.2,BDESH,2018,2019
1905,Mohammad Nabi,2018-2019,3,5,2,2,0,0,2,2 (2ct 0st),0.4,AFG,2018,2019
1906,Mohammad Nawaz,2016-2016,3,6,2,2,0,0,2,1 (1ct 0st),0.3329999999999999,3,2016,2016
1907,AM Moir,1951-1959,17,21,2,2,0,0,2,1 (1ct 0st),0.095,NZ,1951,1959
1908,Mosaddek Hossain,2017-2019,3,5,2,2,0,0,2,1 (1ct 0st),0.4,BDESH,2017,2019
1909,SA Muller,1999-1999,2,4,2,2,0,0,2,1 (1ct 0st),0.5,AUS,1999,1999
1910,N M'shangwe,2014-2014,2,4,2,2,0,0,2,1 (1ct 0st),0.5,ZIM,2014,2014
1911,S Muthusamy,2019-2019,2,3,2,2,0,0,2,2 (2ct 0st),0.6659999999999999,SA,2019,2019
1912,Naeem Islam,2008-2012,8,15,2,2,0,0,2,1 (1ct 0st),0.133,BDESH,2008,2012
1913,Nafees Iqbal,2004-2006,11,15,2,2,0,0,2,1 (1ct 0st),0.133,BDESH,2004,2006
1914,MV Nagamootoo,2000-2002,5,8,2,2,0,0,2,2 (2ct 0st),0.25,WI,2000,2002
1915,R Nanan,1980-1980,1,2,2,2,0,0,2,2 (2ct 0st),1.0,WI,1980,1980
1916,SP Narine,2012-2013,6,11,2,2,0,0,2,1 (1ct 0st),0.181,WI,2012,2013
1917,Najmul Hossain Shanto,2017-2018,2,4,2,2,0,0,2,2 (2ct 0st),0.5,BDESH,2017,2018
1918,RJ Nicol,2012-2012,2,4,2,2,0,0,2,1 (1ct 0st),0.5,NZ,2012,2012
1919,M Nissar,1932-1936,6,11,2,2,0,0,2,1 (1ct 0st),0.181,INDIA,1932,1936
1920,JM Noreiga,1971-1971,4,7,2,2,0,0,2,2 (2ct 0st),0.285,WI,1971,1971
1921,RK Nunes,1928-1930,4,5,2,2,0,1,1,1 (1ct 0st),0.4,WI,1928,1930
1922,J Nyumbu,2014-2016,3,6,2,2,0,0,2,1 (1ct 0st),0.3329999999999999,ZIM,2014,2016
1923,NJ O'Brien,2018-2018,1,2,2,2,0,2,0,2 (2ct 0st),1.0,IRE,2018,2018
1924,J O'Connor,1929-1930,4,8,2,2,0,0,2,2 (2ct 0st),0.25,ENG,1929,1930
1925,D Olivier,2017-2019,10,20,2,2,0,0,2,1 (1ct 0st),0.1,SA,2017,2019
1926,DR O'Sullivan,1973-1976,11,19,2,2,0,0,2,1 (1ct 0st),0.105,NZ,1973,1976
1927,LCH Palairet,1902-1902,2,4,2,2,0,0,2,1 (1ct 0st),0.5,ENG,1902,1902
1928,Pankaj Singh,2014-2014,2,3,2,2,0,0,2,1 (1ct 0st),0.6659999999999999,INDIA,2014,2014
1929,NM Parker,1976-1976,3,6,2,2,0,0,2,1 (1ct 0st),0.3329999999999999,NZ,1976,1976
1930,LS Pascoe,1977-1982,14,27,2,2,0,0,2,1 (1ct 0st),0.074,AUS,1977,1982
1931,JM Patel,1955-1960,7,11,2,2,0,0,2,1 (1ct 0st),0.181,INDIA,1955,1960
1932,MM Patel,1996-1996,2,4,2,2,0,0,2,2 (2ct 0st),0.5,ENG,1996,1996
1933,Yuvraj of Patiala,1934-1934,1,2,2,2,0,0,2,1 (1ct 0st),1.0,INDIA,1934,1934
1934,KMA Paul,2018-2019,3,5,2,2,0,0,2,1 (1ct 0st),0.4,WI,2018,2019
1935,E Peate,1881-1886,9,15,2,2,0,0,2,1 (1ct 0st),0.133,ENG,1881,1886
1936,PDRL Perera,1999-2002,8,14,2,2,0,0,2,1 (1ct 0st),0.142,SL,1999,2002
1937,V Permaul,2012-2015,6,11,2,2,0,0,2,1 (1ct 0st),0.181,WI,2012,2015
1938,AL Phehlukwayo,2017-2018,4,8,2,2,0,0,2,1 (1ct 0st),0.25,SA,2017,2018
1939,WTS Porterfield,2018-2019,3,6,2,2,0,0,2,2 (2ct 0st),0.3329999999999999,IRE,2018,2019
1940,JE Pothecary,1960-1960,3,6,2,2,0,0,2,1 (1ct 0st),0.3329999999999999,SA,1960,1960
1941,AD Pougher,1892-1892,1,2,2,2,0,0,2,1 (1ct 0st),1.0,ENG,1892,1892
1942,AW Powell,1899-1899,1,2,2,2,0,0,2,2 (2ct 0st),1.0,SA,1899,1899
1943,WFF Price,1938-1938,1,2,2,2,0,2,0,2 (2ct 0st),1.0,ENG,1938,1938
1944,HLE Promnitz,1927-1928,2,4,2,2,0,0,2,1 (1ct 0st),0.5,SA,1927,1928
1945,G Pullar,1959-1963,28,50,2,2,0,0,2,1 (1ct 0st),0.04,ENG,1959,1963
1946,PM Pushpakumara,2017-2018,4,6,2,2,0,0,2,2 (2ct 0st),0.3329999999999999,SL,2017,2018
1947,AJ Pycroft,1992-1992,3,5,2,2,0,0,2,1 (1ct 0st),0.4,ZIM,1992,1992
1948,CG Rackemann,1982-1991,12,20,2,2,0,0,2,1 (1ct 0st),0.1,AUS,1982,1991
1949,Rahmat Shah,2018-2019,4,7,2,2,0,0,2,1 (1ct 0st),0.285,AFG,2018,2019
1950,RR Ramdass,2005-2005,1,2,2,2,0,0,2,2 (2ct 0st),1.0,WI,2005,2005
1951,S Ranatunga,1994-1997,9,13,2,2,0,0,2,1 (1ct 0st),0.153,SL,1994,1997
1952,Rashid Khan,1982-1985,4,7,2,2,0,0,2,1 (1ct 0st),0.285,PAK,1982,1985
1953,DA Renneberg,1966-1968,8,15,2,2,0,0,2,1 (1ct 0st),0.133,AUS,1966,1968
1954,JB Robertson,1935-1936,3,5,2,2,0,0,2,1 (1ct 0st),0.4,SA,1935,1936
1955,A Rose-Innes,1889-1889,2,3,2,2,0,0,2,2 (2ct 0st),0.6659999999999999,SA,1889,1889
1956,TW Routledge,1892-1896,4,5,2,2,0,0,2,1 (1ct 0st),0.4,SA,1892,1896
1957,VPFA Royle,1879-1879,1,2,2,2,0,0,2,2 (2ct 0st),1.0,ENG,1879,1879
1958,Saleem Jaffar,1986-1992,14,26,2,2,0,0,2,1 (1ct 0st),0.076,PAK,1986,1992
1959,RO Scarlett,1960-1960,3,6,2,2,0,0,2,1 (1ct 0st),0.3329999999999999,WI,1960,1960
1960,BN Schultz,1992-1997,9,15,2,2,0,0,2,1 (1ct 0st),0.133,SA,1992,1997
1961,CP Senanayake,1991-1991,3,6,2,2,0,0,2,1 (1ct 0st),0.3329999999999999,SL,1991,1991
1962,MA Seymour,1963-1970,7,12,2,2,0,0,2,1 (1ct 0st),0.166,SA,1963,1970
1963,Shafiul Islam,2010-2017,11,21,2,2,0,0,2,1 (1ct 0st),0.095,BDESH,2010,2017
1964,OA Shah,2006-2009,6,9,2,2,0,0,2,1 (1ct 0st),0.222,ENG,2006,2009
1965,Shahid Israr,1976-1976,1,2,2,2,0,2,0,2 (2ct 0st),1.0,PAK,1976,1976
1966,A Shahzad,2010-2010,1,2,2,2,0,0,2,1 (1ct 0st),1.0,ENG,2010,2010
1967,G Sharma,1985-1990,5,9,2,2,0,0,2,1 (1ct 0st),0.222,INDIA,1985,1990
1968,DA Sharpe,1959-1959,3,6,2,2,0,0,2,2 (2ct 0st),0.3329999999999999,PAK,1959,1959
1969,JW Sharpe,1890-1892,3,6,2,2,0,0,2,1 (1ct 0st),0.3329999999999999,ENG,1890,1892
1970,PP Shaw,2018-2018,2,4,2,2,0,0,2,2 (2ct 0st),0.5,INDIA,2018,2018
1971,BK Shepherd,1963-1965,9,18,2,2,0,0,2,1 (1ct 0st),0.111,AUS,1963,1965
1972,GH Shepstone,1896-1899,2,3,2,2,0,0,2,2 (2ct 0st),0.6659999999999999,SA,1896,1899
1973,GC Shillingford,1969-1972,7,12,2,2,0,0,2,2 (2ct 0st),0.166,WI,1969,1972
1974,MJF Shrimpton,1963-1974,10,17,2,2,0,0,2,1 (1ct 0st),0.1169999999999999,NZ,1963,1974
1975,Sikandar Raza,2013-2018,12,21,2,2,0,0,2,1 (1ct 0st),0.095,ZIM,2013,2018
1976,ARS Silva,2017-2019,12,23,2,2,0,0,2,1 (1ct 0st),0.086,SL,2017,2019
1977,CEW Silverwood,1996-2002,6,9,2,2,0,0,2,1 (1ct 0st),0.222,ENG,1996,2002
1978,DJ Sincock,1964-1966,3,5,2,2,0,0,2,2 (2ct 0st),0.4,AUS,1964,1966
1979,CK Singh,1960-1960,2,4,2,2,0,0,2,1 (1ct 0st),0.5,WI,1960,1960
1980,VA Singh,2017-2017,3,6,2,2,0,0,2,1 (1ct 0st),0.3329999999999999,WI,2017,2017
1981,CJE Smith,1902-1902,3,6,2,2,0,0,2,2 (2ct 0st),0.3329999999999999,SA,1902,1902
1982,DR Smith,1961-1962,5,8,2,2,0,0,2,1 (1ct 0st),0.25,ENG,1961,1962
1983,FW Smith,1889-1896,3,4,2,2,0,2,0,2 (2ct 0st),0.5,SA,1889,1896
1984,SD Snooke,1907-1907,1,2,2,2,0,0,2,2 (2ct 0st),1.0,SA,1907,1907
1985,Sohail Khan,2009-2016,9,17,2,2,0,0,2,1 (1ct 0st),0.1169999999999999,PAK,2009,2016
1986,Sohail Tanvir,2007-2007,2,4,2,2,0,0,2,1 (1ct 0st),0.5,PAK,2007,2007
1987,SW Sohoni,1946-1951,4,6,2,2,0,0,2,1 (1ct 0st),0.3329999999999999,INDIA,1946,1951
1988,J Southerton,1877-1877,2,4,2,2,0,0,2,1 (1ct 0st),0.5,ENG,1877,1877
1989,GR Stead,1999-1999,5,9,2,2,0,0,2,1 (1ct 0st),0.222,NZ,1999,1999
1990,GB Stevens,1959-1960,4,8,2,2,0,0,2,1 (1ct 0st),0.25,AUS,1959,1960
1991,RB Stewart,1889-1889,1,2,2,2,0,0,2,2 (2ct 0st),1.0,SA,1889,1889
1992,CEL Stuart,2000-2001,6,12,2,2,0,0,2,1 (1ct 0st),0.166,WI,2000,2001
1993,Khaled Ahmed,2018-2019,2,3,2,2,0,0,2,1 (1ct 0st),0.6659999999999999,BDESH,2018,2019
1994,AB Tancred,1889-1889,2,3,2,2,0,0,2,1 (1ct 0st),0.6659999999999999,SA,1889,1889
1995,FW Tate,1902-1902,1,2,2,2,0,0,2,1 (1ct 0st),1.0,ENG,1902,1902
1996,DD Taylor,1947-1956,3,5,2,2,0,0,2,1 (1ct 0st),0.4,NZ,1947,1956
1997,VP Terry,1984-1984,2,3,2,2,0,0,2,1 (1ct 0st),0.6659999999999999,ENG,1984,1984
1998,DT Tiripano,2014-2018,7,13,2,2,0,0,2,1 (1ct 0st),0.153,ZIM,2014,2018
1999,LF Townsend,1930-1934,4,8,2,2,0,0,2,1 (1ct 0st),0.25,ENG,1930,1934
2000,JC Tredwell,2010-2015,2,4,2,2,0,0,2,1 (1ct 0st),0.5,ENG,2010,2015
2001,J Trim,1948-1952,4,8,2,2,0,0,2,1 (1ct 0st),0.25,WI,1948,1952
2002,GB Troup,1976-1986,15,28,2,2,0,0,2,1 (1ct 0st),0.071,NZ,1976,1986
2003,LR Tuckett,1914-1914,1,2,2,2,0,0,2,2 (2ct 0st),1.0,SA,1914,1914
2004,GE Tyldesley,1921-1929,14,25,2,2,0,0,2,1 (1ct 0st),0.08,ENG,1921,1929
2005,ML Udawatte,2018-2018,2,4,2,2,0,0,2,1 (1ct 0st),0.5,SL,2018,2018
2006,P Utseya,2004-2013,4,6,2,2,0,0,2,2 (2ct 0st),0.3329999999999999,ZIM,2004,2013
2007,BH Valentine,1933-1939,7,13,2,2,0,0,2,1 (1ct 0st),0.153,ENG,1933,1939
2008,BV Vitori,2011-2013,4,7,2,2,0,0,2,1 (1ct 0st),0.285,ZIM,2011,2013
2009,E Wainwright,1893-1898,5,8,2,2,0,0,2,1 (1ct 0st),0.25,ENG,1893,1898
2010,FH Walters,1885-1885,1,1,2,2,0,0,2,2 (2ct 0st),2.0,AUS,1885,1885
2011,B Warnapura,1982-1982,4,7,2,2,0,0,2,1 (1ct 0st),0.285,SL,1982,1982
2012,WJ Watson,1955-1955,4,7,2,2,0,0,2,1 (1ct 0st),0.285,AUS,1955,1955
2013,PN Webb,1980-1980,2,4,2,2,0,0,2,1 (1ct 0st),0.5,NZ,1980,1980
2014,AJ Webbe,1879-1879,1,2,2,2,0,0,2,2 (2ct 0st),1.0,ENG,1879,1879
2015,AW Wellard,1937-1938,2,4,2,2,0,0,2,2 (2ct 0st),0.5,ENG,1937,1938
2016,MD Wettimuny,1983-1983,2,3,2,2,0,0,2,2 (2ct 0st),0.6659999999999999,SL,1983,1983
2017,MR Whitney,1981-1992,12,24,2,2,0,0,2,1 (1ct 0st),0.083,AUS,1981,1992
2018,EAV Williams,1939-1948,4,8,2,2,0,0,2,1 (1ct 0st),0.25,WI,1939,1948
2019,Zulqarnain Haider,2010-2010,1,2,2,2,0,2,0,2 (2ct 0st),1.0,PAK,2010,2010
2020,VR Aaron,2011-2015,9,15,1,1,0,0,1,1 (1ct 0st),0.066,INDIA,2011,2015
2021,Abdul Kadir,1964-1965,4,8,1,0,1,0,0,1 (0ct 1st),0.125,PAK,1964,1965
2022,Abu Jayed,2018-2019,7,9,1,1,0,0,1,1 (1ct 0st),0.111,BDESH,2018,2019
2023,HD Ackerman,1998-1998,4,8,1,1,0,0,1,1 (1ct 0st),0.125,SA,1998,1998
2024,MR Adair,2019-2019,1,2,1,1,0,0,1,1 (1ct 0st),0.5,IRE,2019,2019
2025,AR Adams,2002-2002,1,2,1,1,0,0,1,1 (1ct 0st),0.5,NZ,2002,2002
2026,FS Ahangama,1985-1985,3,6,1,1,0,0,1,1 (1ct 0st),0.166,SL,1985,1985
2027,Aizaz Cheema,2011-2012,7,14,1,1,0,0,1,1 (1ct 0st),0.071,PAK,2011,2012
2028,Ali Naqvi,1997-1998,5,8,1,1,0,0,1,1 (1ct 0st),0.125,PAK,1997,1998
2029,IBA Allen,1991-1991,2,3,1,1,0,0,1,1 (1ct 0st),0.3329999999999999,WI,1991,1991
2030,KN Amalean,1986-1988,2,2,1,1,0,0,1,1 (1ct 0st),0.5,SL,1986,1988
2031,JH Anderson,1902-1902,1,2,1,1,0,0,1,1 (1ct 0st),0.5,SA,1902,1902
2032,RW Anderson,1976-1978,9,16,1,1,0,0,1,1 (1ct 0st),0.062,NZ,1976,1978
2033,WM Anderson,1946-1946,1,1,1,1,0,0,1,1 (1ct 0st),1.0,NZ,1946,1946
2034,KV Andrew,1954-1963,2,3,1,1,0,1,0,1 (1ct 0st),0.3329999999999999,ENG,1954,1963
2035,B Andrews,1973-1974,2,3,1,1,0,0,1,1 (1ct 0st),0.3329999999999999,NZ,1973,1974
2036,J Angel,1993-1995,4,7,1,1,0,0,1,1 (1ct 0st),0.142,AUS,1993,1995
2037,ZS Ansari,2016-2016,3,6,1,1,0,0,1,1 (1ct 0st),0.166,ENG,2016,2016
2038,JC Archer,2019-2019,7,13,1,1,0,0,1,1 (1ct 0st),0.076,ENG,2019,2019
2039,Azeem Hafeez,1983-1985,18,28,1,1,0,0,1,1 (1ct 0st),0.035,PAK,1983,1985
2040,FT Badcock,1930-1933,7,10,1,1,0,0,1,1 (1ct 0st),0.1,NZ,1930,1933
2041,SV Bahutule,2001-2001,2,3,1,1,0,0,1,1 (1ct 0st),0.3329999999999999,INDIA,2001,2001
2042,LS Baker,2008-2009,4,7,1,1,0,0,1,1 (1ct 0st),0.142,WI,2008,2009
2043,L Balaji,2003-2005,8,15,1,1,0,0,1,1 (1ct 0st),0.066,INDIA,2003,2005
2044,JC Balderstone,1976-1976,2,4,1,1,0,0,1,1 (1ct 0st),0.25,ENG,1976,1976
2045,JT Ball,2016-2017,4,6,1,1,0,0,1,1 (1ct 0st),0.166,ENG,2016,2017
2046,RT Barber,1956-1956,1,2,1,1,0,0,1,1 (1ct 0st),0.5,NZ,1956,1956
2047,W Barber,1935-1935,2,4,1,1,0,0,1,1 (1ct 0st),0.25,ENG,1935,1935
2048,KJ Barnett,1988-1989,4,8,1,1,0,0,1,1 (1ct 0st),0.125,ENG,1988,1989
2049,JE Barrett,1890-1890,2,4,1,1,0,0,1,1 (1ct 0st),0.25,AUS,1890,1890
2050,HV Baumgartner,1913-1913,1,1,1,1,0,0,1,1 (1ct 0st),1.0,SA,1913,1913
2051,MA Beer,2011-2012,2,3,1,1,0,0,1,1 (1ct 0st),0.3329999999999999,AUS,2011,2012
2052,W Bell,1954-1954,2,4,1,1,0,0,1,1 (1ct 0st),0.25,NZ,1954,1954
2053,DM Bess,2018-2018,2,4,1,1,0,0,1,1 (1ct 0st),0.25,ENG,2018,2018
2054,P Bhandari,1955-1956,3,6,1,1,0,0,1,1 (1ct 0st),0.166,INDIA,1955,1956
2055,BA Bolton,1959-1959,2,2,1,1,0,0,1,1 (1ct 0st),0.5,NZ,1959,1959
2056,JT Botten,1965-1965,3,6,1,1,0,0,1,1 (1ct 0st),0.166,SA,1965,1965
2057,MP Bowden,1889-1889,2,4,1,1,0,1,0,1 (1ct 0st),0.25,ENG,1889,1889
2058,BP Bracewell,1978-1985,6,11,1,1,0,0,1,1 (1ct 0st),0.09,NZ,1978,1985
2059,DH Brain,1992-1995,9,16,1,1,0,0,1,1 (1ct 0st),0.062,ZIM,1992,1995
2060,GR Breese,2002-2002,1,2,1,1,0,0,1,1 (1ct 0st),0.5,WI,2002,2002
2061,DV Brennan,1951-1951,2,4,1,0,1,0,0,1 (0ct 1st),0.25,ENG,1951,1951
2062,GB Brent,1999-2001,4,6,1,1,0,0,1,1 (1ct 0st),0.166,ZIM,1999,2001
2063,AW Briscoe,1935-1939,2,3,1,1,0,0,1,1 (1ct 0st),0.3329999999999999,SA,1935,1939
2064,HR Bromley-Davenport,1896-1899,4,8,1,1,0,0,1,1 (1ct 0st),0.125,ENG,1896,1899
2065,D Brookes,1948-1948,1,2,1,1,0,0,1,1 (1ct 0st),0.5,ENG,1948,1948
2066,A Brown,1961-1961,2,4,1,1,0,0,1,1 (1ct 0st),0.25,ENG,1961,1961
2067,SJE Brown,1996-1996,1,2,1,1,0,0,1,1 (1ct 0st),0.5,ENG,1996,1996
2068,CR Browne,1928-1930,4,6,1,1,0,0,1,1 (1ct 0st),0.166,WI,1928,1930
2069,CGD Burger,1958-1958,2,4,1,1,0,0,1,1 (1ct 0st),0.25,SA,1958,1958
2070,RP Burl,2017-2017,1,1,1,1,0,0,1,1 (1ct 0st),1.0,ZIM,2017,2017
2071,MG Burmester,1992-1992,3,5,1,1,0,0,1,1 (1ct 0st),0.2,ZIM,1992,1992
2072,IP Butchart,1995-1995,1,2,1,1,0,0,1,1 (1ct 0st),0.5,ZIM,1995,1995
2073,HJ Butler,1947-1948,2,4,1,1,0,0,1,1 (1ct 0st),0.25,ENG,1947,1948
2074,IW Callen,1978-1978,1,2,1,1,0,0,1,1 (1ct 0st),0.5,AUS,1978,1978
2075,GD Campbell,1989-1990,4,8,1,1,0,0,1,1 (1ct 0st),0.125,AUS,1989,1990
2076,GM Carew,1935-1949,4,8,1,1,0,0,1,1 (1ct 0st),0.125,WI,1935,1949
2077,HW Chapman,1914-1921,2,4,1,1,0,0,1,1 (1ct 0st),0.25,SA,1914,1921
2078,PP Chawla,2006-2012,3,6,1,1,0,0,1,1 (1ct 0st),0.166,INDIA,2006,2012
2079,GA Chevalier,1970-1970,1,2,1,1,0,0,1,1 (1ct 0st),0.5,SA,1970,1970
2080,JH Childs,1988-1988,2,3,1,1,0,0,1,1 (1ct 0st),0.3329999999999999,ENG,1988,1988
2081,R Clarke,2003-2003,2,4,1,1,0,0,1,1 (1ct 0st),0.25,ENG,2003,2003
2082,JC Clay,1935-1935,1,2,1,1,0,0,1,1 (1ct 0st),0.5,ENG,1935,1935
2083,SK Coen,1927-1928,2,4,1,1,0,0,1,1 (1ct 0st),0.25,SA,1927,1928
2084,LJ Coldwell,1962-1964,7,14,1,1,0,0,1,1 (1ct 0st),0.071,ENG,1962,1964
2085,DJ Colley,1972-1972,3,6,1,1,0,0,1,1 (1ct 0st),0.166,AUS,1972,1972
2086,JMM Commaille,1910-1928,12,19,1,1,0,0,1,1 (1ct 0st),0.052,SA,1910,1928
2087,DP Conyngham,1923-1923,1,2,1,1,0,0,1,1 (1ct 0st),0.5,SA,1923,1923
2088,AHC Cooper,1913-1913,1,1,1,1,0,0,1,1 (1ct 0st),1.0,SA,1913,1913
2089,WH Cooper,1881-1884,2,4,1,1,0,0,1,1 (1ct 0st),0.25,AUS,1881,1884
2090,GA Cope,1977-1978,3,5,1,1,0,0,1,1 (1ct 0st),0.2,ENG,1977,1978
2091,WH Copson,1939-1947,3,6,1,1,0,0,1,1 (1ct 0st),0.166,ENG,1939,1947
2092,JT Cottam,1887-1887,1,2,1,1,0,0,1,1 (1ct 0st),0.5,AUS,1887,1887
2093,JL Cox,1913-1914,3,4,1,1,0,0,1,1 (1ct 0st),0.25,SA,1913,1914
2094,J Cranston,1890-1890,1,2,1,1,0,0,1,1 (1ct 0st),0.5,ENG,1890,1890
2095,WPA Crawford,1956-1956,4,8,1,1,0,0,1,1 (1ct 0st),0.125,AUS,1956,1956
2096,IB Cromb,1931-1932,5,7,1,1,0,0,1,1 (1ct 0st),0.142,NZ,1931,1932
2097,AC Cummins,1993-1994,5,9,1,1,0,0,1,1 (1ct 0st),0.111,WI,1993,1994
2098,RS Cunis,1964-1972,20,38,1,1,0,0,1,1 (1ct 0st),0.026,NZ,1964,1972
2099,KM Dabengwa,2005-2005,3,4,1,1,0,0,1,1 (1ct 0st),0.25,ZIM,2005,2005
2100,A Dananjaya,2018-2019,6,12,1,1,0,0,1,1 (1ct 0st),0.083,SL,2018,2019
2101,HT Dani,1952-1952,1,2,1,1,0,0,1,1 (1ct 0st),0.5,INDIA,1952,1952
2102,BA Davis,1965-1965,4,7,1,1,0,0,1,1 (1ct 0st),0.142,WI,1965,1965
2103,FI de Caires,1930-1930,3,6,1,1,0,0,1,1 (1ct 0st),0.166,WI,1930,1930
2104,M de Lange,2011-2012,2,4,1,1,0,0,1,1 (1ct 0st),0.25,SA,2011,2012
2105,EW Dempster,1953-1954,5,9,1,1,0,0,1,1 (1ct 0st),0.111,NZ,1953,1954
2106,SI de Saram,1999-2000,4,8,1,1,0,0,1,1 (1ct 0st),0.125,SL,1999,2000
2107,SKL de Silva,1997-1997,3,4,1,1,0,1,0,1 (1ct 0st),0.25,SL,1997,1997
2108,WRS de Silva,2002-2007,3,6,1,1,0,0,1,1 (1ct 0st),0.166,SL,2002,2007
2109,F de Wet,2009-2010,2,4,1,1,0,0,1,1 (1ct 0st),0.25,SA,2009,2010
2110,R Dhanraj,1994-1996,4,8,1,1,0,0,1,1 (1ct 0st),0.125,WI,1994,1996
2111,CD Dixon,1914-1914,1,2,1,1,0,0,1,1 (1ct 0st),0.5,SA,1914,1914
2112,HE Dollery,1947-1950,4,8,1,1,0,0,1,1 (1ct 0st),0.125,ENG,1947,1950
2113,A Dolphin,1921-1921,1,2,1,1,0,1,0,1 (1ct 0st),0.5,ENG,1921,1921
2114,A Ducat,1921-1921,1,2,1,1,0,0,1,1 (1ct 0st),0.5,ENG,1921,1921
2115,BM Duckett,2016-2016,4,8,1,1,0,0,1,1 (1ct 0st),0.125,ENG,2016,2016
2116,T Duffin,2005-2005,2,3,1,1,0,0,1,1 (1ct 0st),0.3329999999999999,ZIM,2005,2005
2117,OR Dunell,1889-1889,2,3,1,1,0,0,1,1 (1ct 0st),0.3329999999999999,SA,1889,1889
2118,JF du Toit,1892-1892,1,1,1,1,0,0,1,1 (1ct 0st),1.0,SA,1892,1892
2119,G Dymock,1974-1980,21,35,1,1,0,0,1,1 (1ct 0st),0.0279999999999999,AUS,1974,1980
2120,Ebadat Hossain,2019-2019,4,4,1,1,0,0,1,1 (1ct 0st),0.25,BDESH,2019,2019
2121,JD Edwards,1888-1888,3,4,1,1,0,0,1,1 (1ct 0st),0.25,AUS,1888,1888
2122,Elias Sunny,2011-2013,4,7,1,1,0,0,1,1 (1ct 0st),0.142,BDESH,2011,2013
2123,S Elworthy,1998-2002,4,8,1,1,0,0,1,1 (1ct 0st),0.125,SA,1998,2002
2124,L Embuldeniya,2019-2019,5,9,1,1,0,0,1,1 (1ct 0st),0.111,SL,2019,2019
2125,Enamul Haque,2001-2003,10,13,1,1,0,0,1,1 (1ct 0st),0.076,BDESH,2001,2003
2126,CN Evans,1996-2003,3,4,1,1,0,0,1,1 (1ct 0st),0.25,ZIM,1996,2003
2127,GM Ewing,2003-2005,3,5,1,1,0,0,1,1 (1ct 0st),0.2,ZIM,2003,2005
2128,Fahim Muntasir,2002-2002,3,4,1,1,0,0,1,1 (1ct 0st),0.25,BDESH,2002,2002
2129,K Farnes,1934-1939,15,27,1,1,0,0,1,1 (1ct 0st),0.037,ENG,1934,1939
2130,KHRK Fernando,2002-2002,2,3,1,1,0,0,1,1 (1ct 0st),0.3329999999999999,SL,2002,2002
2131,LB Fishlock,1936-1947,4,7,1,1,0,0,1,1 (1ct 0st),0.142,ENG,1936,1947
2132,BC Francis,1972-1972,3,6,1,1,0,0,1,1 (1ct 0st),0.166,AUS,1972,1972
2133,HH Francis,1899-1899,2,4,1,1,0,0,1,1 (1ct 0st),0.25,SA,1899,1899
2134,JER Gallian,1995-1995,3,4,1,1,0,0,1,1 (1ct 0st),0.25,ENG,1995,1995
2135,A Gandotra,1969-1969,2,4,1,1,0,0,1,1 (1ct 0st),0.25,INDIA,1969,1969
2136,BBM Gaskin,1948-1948,2,4,1,1,0,0,1,1 (1ct 0st),0.25,WI,1948,1948
2137,RA Gaunt,1958-1964,3,5,1,1,0,0,1,1 (1ct 0st),0.2,AUS,1958,1964
2138,GL Gibbs,1955-1955,1,2,1,1,0,0,1,1 (1ct 0st),0.5,WI,1955,1955
2139,WF Giffen,1887-1892,3,5,1,1,0,0,1,1 (1ct 0st),0.2,AUS,1887,1892
2140,MR Gillespie,2007-2012,5,8,1,1,0,0,1,1 (1ct 0st),0.125,NZ,2007,2012
2141,H Gimblett,1936-1939,3,6,1,1,0,0,1,1 (1ct 0st),0.166,ENG,1936,1939
2142,N Gordon,1938-1939,5,8,1,1,0,0,1,1 (1ct 0st),0.125,SA,1938,1939
2143,AR Gover,1936-1946,4,7,1,1,0,0,1,1 (1ct 0st),0.142,ENG,1936,1946
2144,EM Grace,1880-1880,1,2,1,1,0,0,1,1 (1ct 0st),0.5,ENG,1880,1880
2145,T Greenhough,1959-1960,4,8,1,1,0,0,1,1 (1ct 0st),0.125,ENG,1959,1960
2146,EJ Gregory,1877-1877,1,2,1,1,0,0,1,1 (1ct 0st),0.5,AUS,1877,1877
2147,RG Gregory,1937-1937,2,4,1,1,0,0,1,1 (1ct 0st),0.25,AUS,1937,1937
2148,MG Grell,1930-1930,1,2,1,1,0,0,1,1 (1ct 0st),0.5,WI,1930,1930
2149,CG Halse,1964-1964,3,6,1,1,0,0,1,1 (1ct 0st),0.166,SA,1964,1964
2150,RA Hamence,1947-1948,3,6,1,1,0,0,1,1 (1ct 0st),0.166,AUS,1947,1948
2151,J Hardstaff snr,1907-1908,5,10,1,1,0,0,1,1 (1ct 0st),0.1,ENG,1907,1908
2152,SR Harmer,2015-2015,5,8,1,1,0,0,1,1 (1ct 0st),0.125,SA,2015,2015
2153,TA Harris,1947-1949,3,6,1,1,0,0,1,1 (1ct 0st),0.166,SA,1947,1949
2154,J Harry,1895-1895,1,2,1,1,0,0,1,1 (1ct 0st),0.5,AUS,1895,1895
2155,MJ Hartigan,1908-1908,2,4,1,1,0,0,1,1 (1ct 0st),0.25,AUS,1908,1908
2156,Haseeb Ahsan,1958-1962,12,20,1,1,0,0,1,1 (1ct 0st),0.05,PAK,1958,1962
2157,Hashmatullah Shahidi,2018-2019,3,5,1,1,0,0,1,1 (1ct 0st),0.2,AFG,2018,2019
2158,Hasibul Hossain,2000-2001,5,6,1,1,0,0,1,1 (1ct 0st),0.166,BDESH,2000,2001
2159,JW Hastings,2012-2012,1,2,1,1,0,0,1,1 (1ct 0st),0.5,AUS,2012,2012
2160,A Hearne,1892-1892,1,2,1,1,0,0,1,1 (1ct 0st),0.5,ENG,1892,1892
2161,M Henderson,1930-1930,1,2,1,1,0,0,1,1 (1ct 0st),0.5,NZ,1930,1930
2162,MC Henriques,2013-2016,4,7,1,1,0,0,1,1 (1ct 0st),0.142,AUS,2013,2016
2163,PA Hibbert,1977-1977,1,2,1,1,0,0,1,1 (1ct 0st),0.5,AUS,1977,1977
2164,A Hill,1877-1877,2,4,1,1,0,0,1,1 (1ct 0st),0.25,ENG,1877,1877
2165,AJL Hill,1896-1896,3,6,1,1,0,0,1,1 (1ct 0st),0.166,ENG,1896,1896
2166,MJ Hilton,1950-1952,4,6,1,1,0,0,1,1 (1ct 0st),0.166,ENG,1950,1952
2167,ELG Hoad,1928-1933,4,5,1,1,0,0,1,1 (1ct 0st),0.2,WI,1928,1933
2168,GB Hogg,1996-2008,7,14,1,1,0,0,1,1 (1ct 0st),0.071,AUS,1996,2008
2169,JM Holland,2016-2018,4,8,1,1,0,0,1,1 (1ct 0st),0.125,AUS,2016,2018
2170,KW Hough,1959-1959,2,2,1,1,0,0,1,1 (1ct 0st),0.5,NZ,1959,1959
2171,WA Hunt,1932-1932,1,2,1,1,0,0,1,1 (1ct 0st),0.5,AUS,1932,1932
2172,LG Hylton,1935-1939,6,12,1,1,0,0,1,1 (1ct 0st),0.083,WI,1935,1939
2173,Iftikhar Ahmed,2016-2019,3,4,1,1,0,0,1,1 (1ct 0st),0.25,PAK,2016,2019
2174,AP Igglesden,1989-1994,3,5,1,1,0,0,1,1 (1ct 0st),0.2,ENG,1989,1994
2175,DEJ Ironside,1953-1954,3,5,1,1,0,0,1,1 (1ct 0st),0.2,SA,1953,1954
2176,Israr Ali,1952-1959,4,7,1,1,0,0,1,1 (1ct 0st),0.142,PAK,1952,1959
2177,SD Jack,1994-1995,2,4,1,1,0,0,1,1 (1ct 0st),0.25,SA,1994,1995
2178,HL Jackson,1949-1961,2,4,1,1,0,0,1,1 (1ct 0st),0.25,ENG,1949,1961
2179,CL Johnson,1896-1896,1,1,1,1,0,0,1,1 (1ct 0st),1.0,SA,1896,1896
2180,TF Johnson,1939-1939,1,2,1,1,0,0,1,1 (1ct 0st),0.5,WI,1939,1939
2181,EC Joyce,2018-2018,1,2,1,1,0,0,1,1 (1ct 0st),0.5,IRE,2018,2018
2182,Kabir Khan,1994-1995,4,7,1,1,0,0,1,1 (1ct 0st),0.142,PAK,1994,1995
2183,S Randiv,2010-2012,12,21,1,1,0,0,1,1 (1ct 0st),0.047,SL,2010,2012
2184,AR Kapoor,1994-1996,4,7,1,1,0,0,1,1 (1ct 0st),0.142,INDIA,1994,1996
2185,SS Karim,2000-2000,1,2,1,1,0,1,0,1 (1ct 0st),0.5,INDIA,2000,2000
2186,C Karunaratne,2019-2019,1,2,1,1,0,0,1,1 (1ct 0st),0.5,SL,2019,2019
2187,TJD Kelly,1877-1879,2,4,1,1,0,0,1,1 (1ct 0st),0.25,AUS,1877,1879
2188,RB Kenny,1958-1960,5,8,1,1,0,0,1,1 (1ct 0st),0.125,INDIA,1958,1960
2189,ESM Kentish,1948-1954,2,4,1,1,0,0,1,1 (1ct 0st),0.25,WI,1948,1954
2190,RB Kerr,1985-1985,2,4,1,1,0,0,1,1 (1ct 0st),0.25,AUS,1985,1985
2191,I Khan,2009-2009,1,2,1,1,0,0,1,1 (1ct 0st),0.5,SA,2009,2009
2192,G Kishenchand,1947-1952,5,5,1,1,0,0,1,1 (1ct 0st),0.2,INDIA,1947,1952
2193,AE Knight,1904-1904,3,6,1,1,0,0,1,1 (1ct 0st),0.166,ENG,1904,1904
2194,DJ Knight,1921-1921,2,4,1,1,0,0,1,1 (1ct 0st),0.25,ENG,1921,1921
2195,CM Kuggeleijn,1988-1988,2,4,1,1,0,0,1,1 (1ct 0st),0.25,NZ,1988,1988
2196,HG Kuhn,2017-2017,4,8,1,1,0,0,1,1 (1ct 0st),0.125,SA,2017,2017
2197,AP Kuiper,1992-1992,1,2,1,1,0,0,1,1 (1ct 0st),0.5,SA,1992,1992
2198,NM Kulkarni,1997-2001,3,3,1,1,0,0,1,1 (1ct 0st),0.3329999999999999,INDIA,1997,2001
2199,RR Kulkarni,1986-1987,3,6,1,1,0,0,1,1 (1ct 0st),0.166,INDIA,1986,1987
2200,DSBP Kuruppu,1987-1991,4,6,1,1,0,1,0,1 (1ct 0st),0.166,SL,1987,1991
2201,MKGCP Lakshitha,2002-2002,2,4,1,1,0,0,1,1 (1ct 0st),0.25,SL,2002,2002
2202,Lall Singh,1932-1932,1,2,1,1,0,0,1,1 (1ct 0st),0.5,INDIA,1932,1932
2203,SG Law,1995-1995,1,2,1,1,0,0,1,1 (1ct 0st),0.5,AUS,1995,1995
2204,PK Lee,1931-1933,2,4,1,1,0,0,1,1 (1ct 0st),0.25,AUS,1931,1933
2205,GB Legge,1927-1930,5,8,1,1,0,0,1,1 (1ct 0st),0.125,ENG,1927,1930
2206,CFH Leslie,1882-1883,4,8,1,1,0,0,1,1 (1ct 0st),0.125,ENG,1882,1883
2207,HDG Leveson Gower,1910-1910,3,6,1,1,0,0,1,1 (1ct 0st),0.166,ENG,1910,1910
2208,SH Lewis,2018-2018,2,2,1,1,0,0,1,1 (1ct 0st),0.5,WI,2018,2018
2209,Liaqat Ali,1975-1978,5,7,1,1,0,0,1,1 (1ct 0st),0.142,PAK,1975,1978
2210,GFJ Liebenberg,1998-1998,5,10,1,1,0,0,1,1 (1ct 0st),0.1,SA,1998,1998
2211,James Lillywhite jnr,1877-1877,2,4,1,1,0,0,1,1 (1ct 0st),0.25,ENG,1877,1877
2212,NV Lindsay,1921-1921,1,2,1,1,0,0,1,1 (1ct 0st),0.5,SA,1921,1921
2213,WVS Ling,1921-1923,6,12,1,1,0,0,1,1 (1ct 0st),0.083,SA,1921,1923
2214,AF Lissette,1956-1956,2,2,1,1,0,0,1,1 (1ct 0st),0.5,NZ,1956,1956
2215,KS Lokuarachchi,2003-2004,4,7,1,1,0,0,1,1 (1ct 0st),0.142,SL,2003,2004
2216,AP Lucas,1879-1884,5,9,1,1,0,0,1,1 (1ct 0st),0.111,ENG,1879,1884
2217,MJ McCague,1993-1994,3,5,1,1,0,0,1,1 (1ct 0st),0.2,ENG,1993,1994
2218,CP McGahey,1902-1902,2,4,1,1,0,0,1,1 (1ct 0st),0.25,ENG,1902,1902
2219,J McIlwraith,1886-1886,1,1,1,1,0,0,1,1 (1ct 0st),1.0,AUS,1886,1886
2220,CJ McKay,2009-2009,1,2,1,1,0,0,1,1 (1ct 0st),0.5,AUS,2009,2009
2221,AH McKinnon,1960-1967,8,16,1,1,0,0,1,1 (1ct 0st),0.062,SA,1960,1967
2222,TN Madondo,1998-2000,3,6,1,1,0,0,1,1 (1ct 0st),0.166,ZIM,1998,2000
2223,NB Mahwire,2002-2005,10,15,1,1,0,0,1,1 (1ct 0st),0.066,ZIM,2002,2005
2224,A Maregwede,2004-2004,2,2,1,1,0,0,1,1 (1ct 0st),0.5,ZIM,2004,2004
2225,CS Marriott,1933-1933,1,2,1,1,0,0,1,1 (1ct 0st),0.5,ENG,1933,1933
2226,HJH Marshall,2000-2006,13,23,1,1,0,0,1,1 (1ct 0st),0.043,NZ,2000,2006
2227,RE Marshall,1951-1952,4,8,1,1,0,0,1,1 (1ct 0st),0.125,WI,1951,1952
2228,T Maruma,2013-2013,1,2,1,1,0,0,1,1 (1ct 0st),0.5,ZIM,2013,2013
2229,WP Masakadza,2018-2018,1,2,1,1,0,0,1,1 (1ct 0st),0.5,ZIM,2018,2018
2230,RAL Massie,1972-1973,6,12,1,1,0,0,1,1 (1ct 0st),0.083,AUS,1972,1973
2231,ADG Matthews,1937-1937,1,2,1,1,0,0,1,1 (1ct 0st),0.5,ENG,1937,1937
2232,CD Matthews,1986-1988,3,6,1,1,0,0,1,1 (1ct 0st),0.166,AUS,1986,1988
2233,W Mead,1899-1899,1,2,1,1,0,0,1,1 (1ct 0st),0.5,ENG,1899,1899
2234,KR Meherhomji,1936-1936,1,1,1,1,0,1,0,1 (1ct 0st),1.0,INDIA,1936,1936
2235,VL Mehra,1955-1964,8,16,1,1,0,0,1,1 (1ct 0st),0.062,INDIA,1955,1964
2236,CA Merry,1933-1933,2,2,1,1,0,0,1,1 (1ct 0st),0.5,WI,1933,1933
2237,KD Meuleman,1946-1946,1,2,1,1,0,0,1,1 (1ct 0st),0.5,AUS,1946,1946
2238,PL Mhambrey,1996-1996,2,4,1,1,0,0,1,1 (1ct 0st),0.25,INDIA,1996,1996
2239,J Middleton,1896-1902,6,11,1,1,0,0,1,1 (1ct 0st),0.09,SA,1896,1902
2240,LSM Miller,1953-1958,13,20,1,1,0,0,1,1 (1ct 0st),0.05,NZ,1953,1958
2241,FW Milligan,1899-1899,2,4,1,1,0,0,1,1 (1ct 0st),0.25,ENG,1899,1899
2242,CH Mills,1892-1892,1,1,1,1,0,0,1,1 (1ct 0st),1.0,SA,1892,1892
2243,JE Mills,1930-1933,7,10,1,1,0,0,1,1 (1ct 0st),0.1,NZ,1930,1933
2244,TB Mitchell,1933-1935,5,9,1,1,0,0,1,1 (1ct 0st),0.111,ENG,1933,1935
2245,Mohammad Ayub,2012-2012,1,2,1,1,0,0,1,1 (1ct 0st),0.5,PAK,2012,2012
2246,Mohammad Farooq,1960-1965,7,11,1,1,0,0,1,1 (1ct 0st),0.09,PAK,1960,1965
2247,Mohammad Hussain,1996-1998,2,3,1,1,0,0,1,1 (1ct 0st),0.3329999999999999,PAK,1996,1998
2248,Mohammad Ramzan,1997-1997,1,1,1,1,0,0,1,1 (1ct 0st),1.0,PAK,1997,1997
2249,Mohammad Talha,2009-2014,4,6,1,1,0,0,1,1 (1ct 0st),0.166,PAK,2009,2014
2250,D Mohammed,2004-2006,5,10,1,1,0,0,1,1 (1ct 0st),0.1,WI,2004,2006
2251,AW Mold,1893-1893,3,5,1,1,0,0,1,1 (1ct 0st),0.2,ENG,1893,1893
2252,BD Morrison,1963-1963,1,1,1,1,0,0,1,1 (1ct 0st),1.0,NZ,1963,1963
2253,EA Moseley,1990-1990,2,4,1,1,0,0,1,1 (1ct 0st),0.25,WI,1990,1990
2254,H Moses,1887-1895,6,12,1,1,0,0,1,1 (1ct 0st),0.083,AUS,1887,1895
2255,AE Moss,1954-1960,9,17,1,1,0,0,1,1 (1ct 0st),0.0579999999999999,ENG,1954,1960
2256,WH Moule,1880-1880,1,2,1,1,0,0,1,1 (1ct 0st),0.5,AUS,1880,1880
2257,Mufasir-ul-Haq,1965-1965,1,2,1,1,0,0,1,1 (1ct 0st),0.5,PAK,1965,1965
2258,CT Mumba,2016-2016,2,4,1,1,0,0,1,1 (1ct 0st),0.25,ZIM,2016,2016
2259,Munir Malik,1959-1962,3,4,1,1,0,0,1,1 (1ct 0st),0.25,PAK,1959,1962
2260,Mustafizur Rahman,2015-2019,13,21,1,1,0,0,1,1 (1ct 0st),0.047,BDESH,2015,2019
2261,S Nadeem,2019-2019,1,2,1,1,0,0,1,1 (1ct 0st),0.5,INDIA,2019,2019
2262,Nasir Jamshed,2013-2013,2,4,1,1,0,0,1,1 (1ct 0st),0.25,PAK,2013,2013
2263,JG Navle,1932-1933,2,4,1,1,0,1,0,1 (1ct 0st),0.25,INDIA,1932,1933
2264,SV Nayak,1982-1982,2,3,1,1,0,0,1,1 (1ct 0st),0.3329999999999999,INDIA,1982,1982
2265,Nayeem Hasan,2018-2019,4,7,1,1,0,0,1,1 (1ct 0st),0.142,BDESH,2018,2019
2266,Nazimuddin,2011-2012,3,5,1,1,0,0,1,1 (1ct 0st),0.2,BDESH,2011,2012
2267,N Ncube,2011-2011,1,2,1,1,0,0,1,1 (1ct 0st),0.5,ZIM,2011,2011
2268,JD Nel,1949-1957,6,10,1,1,0,0,1,1 (1ct 0st),0.1,SA,1949,1957
2269,PJ Newport,1988-1991,3,6,1,1,0,0,1,1 (1ct 0st),0.166,ENG,1988,1991
2270,M Ngam,2000-2001,3,5,1,1,0,0,1,1 (1ct 0st),0.2,SA,2000,2001
2271,Niaz Ahmed,1967-1969,2,4,1,1,0,0,1,1 (1ct 0st),0.25,PAK,1967,1969
2272,G Noblet,1950-1953,3,6,1,1,0,0,1,1 (1ct 0st),0.166,AUS,1950,1953
2273,AL Ochse,1928-1929,3,6,1,1,0,0,1,1 (1ct 0st),0.166,SA,1928,1929
2274,JL Ontong,2002-2004,2,4,1,1,0,0,1,1 (1ct 0st),0.25,SA,2002,2004
2275,C Overton,2017-2019,4,6,1,1,0,0,1,1 (1ct 0st),0.166,ENG,2017,2019
2276,GWF Overton,1953-1954,3,5,1,1,0,0,1,1 (1ct 0st),0.2,NZ,1953,1954
2277,AW Palm,1927-1928,1,2,1,1,0,0,1,1 (1ct 0st),0.5,SA,1927,1928
2278,BA Parchment,2008-2008,2,3,1,1,0,0,1,1 (1ct 0st),0.3329999999999999,WI,2008,2008
2279,GAHM Parkar,1982-1982,1,2,1,1,0,0,1,1 (1ct 0st),0.5,INDIA,1982,1982
2280,DC Parkin,1892-1892,1,1,1,1,0,0,1,1 (1ct 0st),1.0,SA,1892,1892
2281,NT Pascal,2010-2010,2,2,1,1,0,0,1,1 (1ct 0st),0.5,WI,2010,2010
2282,RGM Patel,1988-1988,1,2,1,1,0,0,1,1 (1ct 0st),0.5,INDIA,1988,1988
2283,SR Patil,1955-1955,1,2,1,1,0,0,1,1 (1ct 0st),0.5,INDIA,1955,1955
2284,SG Peall,1993-1994,4,7,1,1,0,0,1,1 (1ct 0st),0.142,ZIM,1993,1994
2285,COC Pearse,1910-1911,3,5,1,1,0,0,1,1 (1ct 0st),0.2,SA,1910,1911
2286,ASA Perera,1998-2001,3,6,1,1,0,0,1,1 (1ct 0st),0.166,SL,1998,2001
2287,NLTC Perera,2011-2012,6,9,1,1,0,0,1,1 (1ct 0st),0.111,SL,2011,2012
2288,RTD Perks,1939-1939,2,3,1,1,0,0,1,1 (1ct 0st),0.3329999999999999,ENG,1939,1939
2289,NO Perry,1999-1999,4,7,1,1,0,0,1,1 (1ct 0st),0.142,WI,1999,1999
2290,OJ Phillips,2009-2009,2,4,1,1,0,0,1,1 (1ct 0st),0.25,WI,2009,2009
2291,CJ Poole,1951-1952,3,5,1,1,0,0,1,1 (1ct 0st),0.2,ENG,1951,1952
2292,MB Poore,1953-1956,14,20,1,1,0,0,1,1 (1ct 0st),0.05,NZ,1953,1956
2293,RL Powell,1999-2004,2,4,1,1,0,0,1,1 (1ct 0st),0.25,WI,1999,2004
2294,D Pretorius,2019-2019,1,2,1,1,0,0,1,1 (1ct 0st),0.5,SA,2019,2019
2295,N Puna,1966-1966,3,5,1,1,0,0,1,1 (1ct 0st),0.2,NZ,1966,1966
2296,NA Quinn,1929-1932,12,19,1,1,0,0,1,1 (1ct 0st),0.052,SA,1929,1932
2297,LS Rajput,1985-1985,2,4,1,1,0,0,1,1 (1ct 0st),0.25,INDIA,1985,1985
2298,L Ramji,1933-1933,1,2,1,1,0,0,1,1 (1ct 0st),0.5,INDIA,1933,1933
2299,KM Rangnekar,1947-1948,3,4,1,1,0,0,1,1 (1ct 0st),0.25,INDIA,1947,1948
2300,VB Ranjane,1958-1964,7,14,1,1,0,0,1,1 (1ct 0st),0.071,INDIA,1958,1964
2301,Ranjan Das,2000-2000,1,2,1,1,0,0,1,1 (1ct 0st),0.5,BDESH,2000,2000
2302,JR Ratnayeke,1982-1989,22,32,1,1,0,0,1,1 (1ct 0st),0.031,SL,1982,1989
2303,JC Reedman,1894-1894,1,2,1,1,0,0,1,1 (1ct 0st),0.5,AUS,1894,1894
2304,DA Reeve,1992-1992,3,6,1,1,0,0,1,1 (1ct 0st),0.166,ENG,1992,1992
2305,MR Rege,1949-1949,1,1,1,1,0,0,1,1 (1ct 0st),1.0,INDIA,1949,1949
2306,SF Rehman,1958-1958,1,2,1,1,0,0,1,1 (1ct 0st),0.5,PAK,1958,1958
2307,JA Rennie,1993-1997,4,8,1,1,0,0,1,1 (1ct 0st),0.125,ZIM,1993,1997
2308,AJ Richardson,1924-1926,9,14,1,1,0,0,1,1 (1ct 0st),0.071,AUS,1924,1926
2309,DW Richardson,1957-1957,1,2,1,1,0,0,1,1 (1ct 0st),0.5,ENG,1957,1957
2310,GR Robertson,1998-1998,4,7,1,1,0,0,1,1 (1ct 0st),0.142,AUS,1998,1998
2311,RH Robinson,1936-1936,1,2,1,1,0,0,1,1 (1ct 0st),0.5,AUS,1936,1936
2312,BG Rogers,2005-2005,4,6,1,1,0,0,1,1 (1ct 0st),0.166,ZIM,2005,2005
2313,CF Root,1926-1926,3,3,1,1,0,0,1,1 (1ct 0st),0.3329999999999999,ENG,1926,1926
2314,GF Rorke,1959-1959,4,8,1,1,0,0,1,1 (1ct 0st),0.125,AUS,1959,1959
2315,CG Rowe,1946-1946,1,1,1,1,0,0,1,1 (1ct 0st),1.0,NZ,1946,1946
2316,JJ Roy,2019-2019,5,10,1,1,0,0,1,1 (1ct 0st),0.1,ENG,2019,2019
2317,P Roy,1982-1982,2,2,1,1,0,0,1,1 (1ct 0st),0.5,INDIA,1982,1982
2318,AD Russell,2010-2010,1,2,1,1,0,0,1,1 (1ct 0st),0.5,WI,2010,2010
2319,MJ Saggers,2003-2004,3,6,1,1,0,0,1,1 (1ct 0st),0.166,ENG,2003,2004
2320,SV Samuelson,1910-1910,1,2,1,1,0,0,1,1 (1ct 0st),0.5,SA,1910,1910
2321,BS Sandhu,1983-1983,8,11,1,1,0,0,1,1 (1ct 0st),0.09,INDIA,1983,1983
2322,Sanwar Hossain,2001-2003,9,11,1,1,0,0,1,1 (1ct 0st),0.09,BDESH,2001,2003
2323,Sarandeep Singh,2000-2002,3,5,1,1,0,0,1,1 (1ct 0st),0.2,INDIA,2000,2002
2324,CJ Sayers,2018-2018,1,2,1,1,0,0,1,1 (1ct 0st),0.5,AUS,2018,2018
2325,AW Seccull,1896-1896,1,1,1,1,0,0,1,1 (1ct 0st),1.0,SA,1896,1896
2326,J Selby,1877-1882,6,11,1,1,0,1,0,1 (1ct 0st),0.09,ENG,1877,1882
2327,RHD Sellers,1964-1964,1,1,1,1,0,0,1,1 (1ct 0st),1.0,AUS,1964,1964
2328,MWW Selvey,1976-1977,3,6,1,1,0,0,1,1 (1ct 0st),0.166,ENG,1976,1977
2329,SMSM Senanayake,2013-2014,1,2,1,1,0,0,1,1 (1ct 0st),0.5,SL,2013,2014
2330,D Shackleton,1950-1963,7,13,1,1,0,0,1,1 (1ct 0st),0.076,ENG,1950,1963
2331,Shadab Khan,2017-2019,5,9,1,1,0,0,1,1 (1ct 0st),0.111,PAK,2017,2019
2332,Shahriar Hossain,2000-2004,3,5,1,0,1,0,0,1 (0ct 1st),0.2,BDESH,2000,2004
2333,Shakeel Ahmed snr,1998-1998,1,2,1,1,0,0,1,1 (1ct 0st),0.5,PAK,1998,1998
2334,MD Shanaka,2016-2017,3,4,1,1,0,0,1,1 (1ct 0st),0.25,SL,2016,2017
2335,AK Sharma,1988-1988,1,2,1,1,0,0,1,1 (1ct 0st),0.5,INDIA,1988,1988
2336,PH Sharma,1974-1977,5,7,1,1,0,0,1,1 (1ct 0st),0.142,INDIA,1974,1977
2337,SK Sharma,1988-1990,2,4,1,1,0,0,1,1 (1ct 0st),0.25,INDIA,1988,1990
2338,J Sharp,1909-1909,3,6,1,1,0,0,1,1 (1ct 0st),0.166,ENG,1909,1909
2339,IT Shillingford,1977-1978,4,8,1,1,0,0,1,1 (1ct 0st),0.125,WI,1977,1978
2340,RH Shodhan,1952-1953,3,6,1,1,0,0,1,1 (1ct 0st),0.166,INDIA,1952,1953
2341,K Shuttleworth,1970-1971,5,9,1,1,0,0,1,1 (1ct 0st),0.111,ENG,1970,1971
2342,IR Siddiqui,2001-2001,1,2,1,1,0,0,1,1 (1ct 0st),0.5,INDIA,2001,2001
2343,KJ Silva,1995-1998,7,12,1,1,0,0,1,1 (1ct 0st),0.083,SL,1995,1998
2344,GHT Simpson-Hayward,1910-1910,5,10,1,1,0,0,1,1 (1ct 0st),0.1,ENG,1910,1910
2345,IM Sinclair,1956-1956,2,3,1,1,0,0,1,1 (1ct 0st),0.3329999999999999,NZ,1956,1956
2346,R Singh,1999-1999,1,2,1,1,0,0,1,1 (1ct 0st),0.5,INDIA,1999,1999
2347,VRV Singh,2006-2007,5,10,1,1,0,0,1,1 (1ct 0st),0.1,INDIA,2006,2007
2348,CIJ Smith,1935-1937,5,9,1,1,0,0,1,1 (1ct 0st),0.111,ENG,1935,1937
2349,D Smith,1935-1935,2,4,1,1,0,0,1,1 (1ct 0st),0.25,ENG,1935,1935
2350,FB Smith,1947-1952,4,7,1,1,0,0,1,1 (1ct 0st),0.142,NZ,1947,1952
2351,H Smith,1928-1928,1,2,1,1,0,1,0,1 (1ct 0st),0.5,ENG,1928,1928
2352,SB Smith,1984-1984,3,6,1,1,0,0,1,1 (1ct 0st),0.166,AUS,1984,1984
2353,TPB Smith,1946-1947,4,5,1,1,0,0,1,1 (1ct 0st),0.2,ENG,1946,1947
2354,RP Snell,1992-1994,5,9,1,1,0,0,1,1 (1ct 0st),0.111,SA,1992,1994
2355,WRT Solomon,1899-1899,1,2,1,1,0,0,1,1 (1ct 0st),0.5,SA,1899,1899
2356,WH St Hill,1928-1930,3,4,1,1,0,0,1,1 (1ct 0st),0.25,WI,1928,1930
2357,DA Stirling,1984-1986,6,11,1,1,0,0,1,1 (1ct 0st),0.09,NZ,1984,1986
2358,MD Stoneman,2017-2018,11,19,1,1,0,0,1,1 (1ct 0st),0.052,ENG,2017,2018
2359,GB Street,1923-1923,1,1,1,0,1,0,0,1 (0ct 1st),1.0,ENG,1923,1923
2360,PC Strydom,2000-2000,2,4,1,1,0,0,1,1 (1ct 0st),0.25,SA,2000,2000
2361,MJ Susskind,1924-1924,5,5,1,1,0,0,1,1 (1ct 0st),0.2,SA,1924,1924
2362,SW Tait,2005-2008,3,6,1,1,0,0,1,1 (1ct 0st),0.166,AUS,2005,2008
2363,Talha Jubair,2002-2004,7,9,1,1,0,0,1,1 (1ct 0st),0.111,BDESH,2002,2004
2364,Tanvir Ahmed,2010-2013,5,10,1,1,0,0,1,1 (1ct 0st),0.1,PAK,2010,2013
2365,GL Tapscott,1913-1913,1,1,1,1,0,0,1,1 (1ct 0st),1.0,SA,1913,1913
2366,Tareq Aziz,2004-2004,3,4,1,1,0,0,1,1 (1ct 0st),0.25,BDESH,2004,2004
2367,Taskin Ahmed,2017-2017,5,10,1,1,0,0,1,1 (1ct 0st),0.1,BDESH,2017,2017
2368,K Taylor,1959-1964,3,6,1,1,0,0,1,1 (1ct 0st),0.166,ENG,1959,1964
2369,LB Taylor,1985-1985,2,4,1,1,0,0,1,1 (1ct 0st),0.25,ENG,1985,1985
2370,G Thornton,1902-1902,1,2,1,1,0,0,1,1 (1ct 0st),0.5,SA,1902,1902
2371,DCH Townsend,1935-1935,3,5,1,1,0,0,1,1 (1ct 0st),0.2,ENG,1935,1935
2372,JPF Travers,1902-1902,1,2,1,1,0,0,1,1 (1ct 0st),0.5,AUS,1902,1902
2373,PB Truscott,1965-1965,1,2,1,1,0,0,1,1 (1ct 0st),0.5,NZ,1965,1965
2374,LL Tsotsobe,2010-2011,5,9,1,1,0,0,1,1 (1ct 0st),0.111,SA,2010,2011
2375,NC Tufnell,1910-1910,1,2,1,0,1,0,0,1 (0ct 1st),0.5,ENG,1910,1910
2376,MJL Turnbull,1930-1936,9,17,1,1,0,0,1,1 (1ct 0st),0.0579999999999999,ENG,1930,1936
2377,Tushar Imran,2002-2007,5,6,1,1,0,0,1,1 (1ct 0st),0.166,BDESH,2002,2007
2378,RK Tyldesley,1924-1930,7,11,1,1,0,0,1,1 (1ct 0st),0.09,ENG,1924,1930
2379,SD Udal,2005-2006,4,7,1,1,0,0,1,1 (1ct 0st),0.142,ENG,2005,2006
2380,Umar Amin,2010-2010,4,8,1,1,0,0,1,1 (1ct 0st),0.125,PAK,2010,2010
2381,PGV van der Bijl,1938-1939,5,8,1,1,0,0,1,1 (1ct 0st),0.125,SA,1938,1939
2382,HE van der Dussen,2019-2019,1,2,1,1,0,0,1,1 (1ct 0st),0.5,SA,2019,2019
2383,M Venkataramana,1989-1989,1,2,1,1,0,0,1,1 (1ct 0st),0.5,INDIA,1989,1989
2384,GH Vihari,2018-2019,7,14,1,1,0,0,1,1 (1ct 0st),0.071,INDIA,2018,2019
2385,DP Viljoen,1998-2000,2,3,1,1,0,0,1,1 (1ct 0st),0.3329999999999999,ZIM,1998,2000
2386,CH Vintcent,1889-1892,3,4,1,1,0,0,1,1 (1ct 0st),0.25,SA,1889,1892
2387,Vizianagram,1936-1936,3,5,1,1,0,0,1,1 (1ct 0st),0.2,INDIA,1936,1936
2388,A Waddington,1920-1921,2,4,1,1,0,0,1,1 (1ct 0st),0.25,ENG,1920,1921
2389,MG Waite,1938-1938,2,3,1,1,0,0,1,1 (1ct 0st),0.3329999999999999,AUS,1938,1938
2390,AC Waller,1996-1996,2,4,1,1,0,0,1,1 (1ct 0st),0.25,ZIM,1996,1996
2391,A Ward,1893-1895,7,13,1,1,0,0,1,1 (1ct 0st),0.076,ENG,1893,1895
2392,FA Ward,1936-1938,4,6,1,1,0,0,1,1 (1ct 0st),0.166,AUS,1936,1938
2393,IJ Ward,2001-2001,5,9,1,1,0,0,1,1 (1ct 0st),0.111,ENG,2001,2001
2394,A Warren,1905-1905,1,2,1,1,0,0,1,1 (1ct 0st),0.5,ENG,1905,1905
2395,AS Wassan,1990-1990,4,7,1,1,0,0,1,1 (1ct 0st),0.142,INDIA,1990,1990
2396,SL Watkin,1991-1993,3,6,1,1,0,0,1,1 (1ct 0st),0.166,ENG,1991,1993
2397,JR Watkins,1973-1973,1,2,1,1,0,0,1,1 (1ct 0st),0.5,AUS,1973,1973
2398,M Watkinson,1995-1996,4,7,1,1,0,0,1,1 (1ct 0st),0.142,ENG,1995,1996
2399,CD Watson,1960-1962,7,14,1,1,0,0,1,1 (1ct 0st),0.071,WI,1960,1962
2400,GD Watson,1966-1972,5,9,1,1,0,0,1,1 (1ct 0st),0.111,AUS,1966,1972
2401,S Wazir Ali,1932-1936,7,13,1,1,0,0,1,1 (1ct 0st),0.076,INDIA,1932,1936
2402,C Wesley,1960-1960,3,5,1,1,0,0,1,1 (1ct 0st),0.2,SA,1960,1960
2403,T Westley,2017-2017,5,10,1,1,0,0,1,1 (1ct 0st),0.1,ENG,2017,2017
2404,JJ Whitaker,1986-1986,1,2,1,1,0,0,1,1 (1ct 0st),0.5,ENG,1986,1986
2405,AW White,1965-1965,2,3,1,1,0,0,1,1 (1ct 0st),0.3329999999999999,WI,1965,1965
2406,CL White,2008-2008,4,8,1,1,0,0,1,1 (1ct 0st),0.125,AUS,2008,2008
2407,RGCE Wijesuriya,1982-1985,4,6,1,1,0,0,1,1 (1ct 0st),0.166,SL,1982,1985
2408,D Wilson,1964-1971,6,12,1,1,0,0,1,1 (1ct 0st),0.083,ENG,1964,1971
2409,PL Winslow,1950-1955,5,8,1,1,0,0,1,1 (1ct 0st),0.125,SA,1950,1955
2410,AJ Woodcock,1974-1974,1,2,1,1,0,0,1,1 (1ct 0st),0.5,AUS,1974,1974
2411,J Yadav,2016-2017,4,8,1,1,0,0,1,1 (1ct 0st),0.125,INDIA,2016,2017
2412,T Yohannan,2001-2002,3,6,1,1,0,0,1,1 (1ct 0st),0.166,INDIA,2001,2002
2413,HI Young,1899-1899,2,4,1,1,0,0,1,1 (1ct 0st),0.25,ENG,1899,1899
2414,Zahoor Elahi,1996-1996,2,4,1,1,0,0,1,1 (1ct 0st),0.25,PAK,1996,1996
2415,Zakir Khan,1986-1989,2,4,1,1,0,0,1,1 (1ct 0st),0.25,PAK,1986,1989
2416,M Zondeki,2003-2008,6,11,1,1,0,0,1,1 (1ct 0st),0.09,SA,2003,2008
2417,Abdur Rauf,2009-2009,3,6,0,0,0,0,0,0,0.0,PAK,2009,2009
2418,Abid Ali,2019-2019,2,3,0,0,0,0,0,0,0.0,PAK,2019,2019
2419,CA Absolom,1879-1879,1,2,0,0,0,0,0,0,0.0,ENG,1879,1879
2420,Aftab Baloch,1969-1975,2,4,0,0,0,0,0,0,0.0,PAK,1969,1975
2421,U Afzaal,2001-2001,3,4,0,0,0,0,0,0,0.0,ENG,2001,2001
2422,AC Agar,2013-2017,4,8,0,0,0,0,0,0,0.0,AUS,2013,2017
2423,Agha Zahid,1975-1975,1,2,0,0,0,0,0,0,0.0,PAK,1975,1975
2424,JP Agnew,1984-1985,3,6,0,0,0,0,0,0,0.0,ENG,1984,1985
2425,Alamgir Kabir,2002-2004,3,4,0,0,0,0,0,0,0.0,BDESH,2002,2004
2426,HH Alexander,1933-1933,1,2,0,0,0,0,0,0,0.0,AUS,1933,1933
2427,Imtiaz Ali,1976-1976,1,2,0,0,0,0,0,0,0.0,WI,1976,1976
2428,Kabir Ali,2003-2003,1,2,0,0,0,0,0,0,0.0,ENG,2003,2003
2429,Ali Hussain Rizvi,1997-1997,1,1,0,0,0,0,0,0,0.0,PAK,1997,1997
2430,FE Allan,1879-1879,1,2,0,0,0,0,0,0,0.0,AUS,1879,1879
2431,PJ Allan,1965-1965,1,2,0,0,0,0,0,0,0.0,AUS,1965,1965
2432,MJC Allom,1930-1931,5,8,0,0,0,0,0,0,0.0,ENG,1930,1931
2433,Al-Amin Hossain,2013-2019,7,11,0,0,0,0,0,0,0.0,BDESH,2013,2019
2434,MKDI Amerasinghe,2008-2008,1,2,0,0,0,0,0,0,0.0,SL,2008,2008
2435,Amir Elahi,1947-1952,6,9,0,0,0,0,0,0,0.0,INDIA/PAK,1947,1952
2436,Amir Hamza,2019-2019,1,2,0,0,0,0,0,0,0.0,AFG,2019,2019
2437,SA Ankola,1989-1989,1,2,0,0,0,0,0,0,0.0,INDIA,1989,1989
2438,Anwar Hossain Monir,2003-2005,3,3,0,0,0,0,0,0,0.0,BDESH,2003,2005
2439,Anwar Hossain,2002-2002,1,1,0,0,0,0,0,0,0.0,BDESH,2002,2002
2440,Anwar Hussain,1952-1952,4,6,0,0,0,0,0,0,0.0,PAK,1952,1952
2441,Anwar Khan,1979-1979,1,2,0,0,0,0,0,0,0.0,PAK,1979,1979
2442,AL Apte,1959-1959,1,1,0,0,0,0,0,0,0.0,INDIA,1959,1959
2443,AG Archer,1899-1899,1,2,0,0,0,0,0,0,0.0,ENG,1899,1899
2444,KA Archer,1950-1951,5,10,0,0,0,0,0,0,0.0,AUS,1950,1951
2445,Arif Butt,1964-1965,3,6,0,0,0,0,0,0,0.0,PAK,1964,1965
2446,T Armitage,1877-1877,2,4,0,0,0,0,0,0,0.0,ENG,1877,1877
2447,J Arnold,1931-1931,1,2,0,0,0,0,0,0,0.0,ENG,1931,1931
2448,Arshad Khan,1997-2005,9,17,0,0,0,0,0,0,0.0,PAK,1997,2005
2449,NS Asgarali,1957-1957,2,2,0,0,0,0,0,0,0.0,WI,1957,1957
2450,Ashfaq Ahmed,1993-1993,1,2,0,0,0,0,0,0,0.0,PAK,1993,1993
2451,WH Ashley,1889-1889,1,1,0,0,0,0,0,0,0.0,SA,1889,1889
2452,Atif Rauf,1994-1994,1,2,0,0,0,0,0,0,0.0,PAK,1994,1994
2453,Azam Khan,1996-1996,1,2,0,0,0,0,0,0,0.0,PAK,1996,1996
2454,Azhar Khan,1980-1980,1,2,0,0,0,0,0,0,0.0,PAK,1980,1980
2455,Azmat Rana,1980-1980,1,2,0,0,0,0,0,0,0.0,PAK,1980,1980
2456,RJ Bailey,1988-1990,4,7,0,0,0,0,0,0,0.0,ENG,1988,1990
2457,MRCN Bandaratilleke,1998-2001,7,14,0,0,0,0,0,0,0.0,SL,1998,2001
2458,SN Banerjee,1949-1949,1,2,0,0,0,0,0,0,0.0,INDIA,1949,1949
2459,ST Banerjee,1992-1992,1,2,0,0,0,0,0,0,0.0,INDIA,1992,1992
2460,C Bannerman,1877-1879,3,6,0,0,0,0,0,0,0.0,AUS,1877,1879
2461,M Baqa Jilani,1936-1936,1,2,0,0,0,0,0,0,0.0,INDIA,1936,1936
2462,GD Barlow,1976-1977,3,6,0,0,0,0,0,0,0.0,ENG,1976,1977
2463,AG Barrett,1971-1975,6,10,0,0,0,0,0,0,0.0,WI,1971,1975
2464,VA Barton,1892-1892,1,2,0,0,0,0,0,0,0.0,ENG,1892,1892
2465,GR Beard,1980-1980,3,4,0,0,0,0,0,0,0.0,AUS,1980,1980
2466,JEF Beck,1953-1956,8,14,0,0,0,0,0,0,0.0,NZ,1953,1956
2467,J Benaud,1972-1973,3,6,0,0,0,0,0,0,0.0,AUS,1972,1973
2468,JE Benjamin,1994-1994,1,2,0,0,0,0,0,0,0.0,ENG,1994,1994
2469,HK Bennett,2010-2010,1,2,0,0,0,0,0,0,0.0,NZ,2010,2010
2470,MR Benson,1986-1986,1,2,0,0,0,0,0,0,0.0,ENG,1986,1986
2471,DE Bernard,2003-2009,3,6,0,0,0,0,0,0,0.0,WI,2003,2009
2472,BJ Bess,2010-2010,1,2,0,0,0,0,0,0,0.0,WI,2010,2010
2473,N Betancourt,1930-1930,1,2,0,0,0,0,0,0,0.0,WI,1930,1930
2474,AR Bhat,1983-1983,2,3,0,0,0,0,0,0,0.0,INDIA,1983,1983
2475,Bilawal Bhatti,2013-2014,2,4,0,0,0,0,0,0,0.0,PAK,2013,2014
2476,GF Bissett,1927-1928,4,8,0,0,0,0,0,0,0.0,SA,1927,1928
2477,MI Black,2000-2002,6,10,0,0,0,0,0,0,0.0,WI,2000,2002
2478,ID Blackwell,2006-2006,1,2,0,0,0,0,0,0,0.0,ENG,2006,2006
2479,EG Bock,1935-1935,1,2,0,0,0,0,0,0,0.0,SA,1935,1935
2480,GE Bond,1938-1938,1,2,0,0,0,0,0,0,0.0,SA,1938,1938
2481,MW Booth,1913-1914,2,4,0,0,0,0,0,0,0.0,ENG,1913,1914
2482,T Bosch,1992-1992,1,2,0,0,0,0,0,0,0.0,SA,1992,1992
2483,WM Bradley,1899-1899,2,4,0,0,0,0,0,0,0.0,ENG,1899,1899
2484,CR Brathwaite,2015-2016,3,4,0,0,0,0,0,0,0.0,WI,2015,2016
2485,W Brearley,1905-1912,4,8,0,0,0,0,0,0,0.0,ENG,1905,1912
2486,GA Briant,1993-1993,1,1,0,0,0,0,0,0,0.0,ZIM,1993,1993
2487,NT Broom,2017-2017,2,4,0,0,0,0,0,0,0.0,NZ,2017,2017
2488,LS Brown,1931-1932,2,3,0,0,0,0,0,0,0.0,SA,1931,1932
2489,GK Bruk-Jackson,1993-1993,2,4,0,0,0,0,0,0,0.0,ZIM,1993,1993
2490,C Burke,1946-1946,1,1,0,0,0,0,0,0,0.0,NZ,1946,1946
2491,SF Burke,1962-1965,2,4,0,0,0,0,0,0,0.0,SA,1962,1965
2492,EJK Burn,1890-1890,2,4,0,0,0,0,0,0,0.0,AUS,1890,1890
2493,AR Butcher,1979-1979,1,2,0,0,0,0,0,0,0.0,ENG,1979,1979
2494,LS Butler,1955-1955,1,1,0,0,0,0,0,0,0.0,WI,1955,1955
2495,LA Butterfield,1946-1946,1,1,0,0,0,0,0,0,0.0,NZ,1946,1946
2496,ID Buys,1922-1922,1,2,0,0,0,0,0,0,0.0,SA,1922,1922
2497,ST Callaway,1892-1895,3,6,0,0,0,0,0,0,0.0,AUS,1892,1895
2498,FJ Cameron,1948-1949,5,10,0,0,0,0,0,0,0.0,WI,1948,1949
2499,JH Cameron,1939-1939,2,4,0,0,0,0,0,0,0.0,WI,1939,1939
2500,DB Carr,1951-1952,2,2,0,0,0,0,0,0,0.0,ENG,1951,1952
2501,DW Carr,1909-1909,1,2,0,0,0,0,0,0,0.0,ENG,1909,1909
2502,HWR Cartwright,2017-2017,2,4,0,0,0,0,0,0,0.0,AUS,2017,2017
2503,G Challenor,1928-1928,3,3,0,0,0,0,0,0,0.0,WI,1928,1928
2504,HS Chang,1979-1979,1,2,0,0,0,0,0,0,0.0,WI,1979,1979
2505,PC Charlton,1890-1890,2,4,0,0,0,0,0,0,0.0,AUS,1890,1890
2506,HRJ Charlwood,1877-1877,2,4,0,0,0,0,0,0,0.0,ENG,1877,1877
2507,TL Chatara,2013-2018,9,17,0,0,0,0,0,0,0.0,ZIM,2013,2018
2508,W Chatterton,1892-1892,1,2,0,0,0,0,0,0,0.0,ENG,1892,1892
2509,CJ Chibhabha,2016-2017,3,4,0,0,0,0,0,0,0.0,ZIM,2016,2017
2510,MT Chinouya,2016-2016,2,3,0,0,0,0,0,0,0.0,ZIM,2016,2016
2511,TS Chisoro,2017-2017,1,1,0,0,0,0,0,0,0.0,ZIM,2017,2017
2512,N Chopra,2000-2000,1,1,0,0,0,0,0,0,0.0,INDIA,2000,2000
2513,NR Chowdhury,1949-1951,2,3,0,0,0,0,0,0,0.0,INDIA,1949,1951
2514,S Christopherson,1884-1884,1,2,0,0,0,0,0,0,0.0,ENG,1884,1884
2515,GWA Chubb,1951-1951,5,9,0,0,0,0,0,0,0.0,SA,1951,1951
2516,EW Clark,1929-1934,8,15,0,0,0,0,0,0,0.0,ENG,1929,1934
2517,CB Clarke,1939-1939,3,6,0,0,0,0,0,0,0.0,WI,1939,1939
2518,DC Cleverley,1932-1946,2,2,0,0,0,0,0,0,0.0,NZ,1932,1946
2519,JAK Cochran,1931-1931,1,2,0,0,0,0,0,0,0.0,SA,1931,1931
2520,A Coningham,1894-1895,1,2,0,0,0,0,0,0,0.0,AUS,1894,1895
2521,C Cook,1947-1947,1,2,0,0,0,0,0,0,0.0,ENG,1947,1947
2522,FJ Cook,1896-1896,1,2,0,0,0,0,0,0,0.0,SA,1896,1896
2523,SH Cook,1997-1997,2,4,0,0,0,0,0,0,0.0,AUS,1997,1997
2524,SJ Cook,1992-1993,3,5,0,0,0,0,0,0,0.0,SA,1992,1993
2525,GE Corling,1964-1964,5,8,0,0,0,0,0,0,0.0,AUS,1964,1964
2526,SS Cottrell,2013-2014,2,2,0,0,0,0,0,0,0.0,WI,2013,2014
2527,G Coulthard,1882-1882,1,2,0,0,0,0,0,0,0.0,AUS,1882,1882
2528,Hon.CJ Coventry,1889-1889,2,4,0,0,0,0,0,0,0.0,ENG,1889,1889
2529,A Coxon,1948-1948,1,2,0,0,0,0,0,0,0.0,ENG,1948,1948
2530,MS Crane,2018-2018,1,1,0,0,0,0,0,0,0.0,ENG,2018,2018
2531,Z Crawley,2019-2019,1,2,0,0,0,0,0,0,0.0,ENG,2019,2019
2532,GF Cresswell,1949-1951,3,4,0,0,0,0,0,0,0.0,NZ,1949,1951
2533,G Cripps,1892-1892,1,1,0,0,0,0,0,0,0.0,SA,1892,1892
2534,GJ Crocker,1992-1992,3,5,0,0,0,0,0,0,0.0,ZIM,1992,1992
2535,DJ Cullen,2006-2006,1,2,0,0,0,0,0,0,0.0,AUS,2006,2006
2536,TK Curran,2017-2018,2,3,0,0,0,0,0,0,0.0,ENG,2017,2018
2537,AC Dale,1998-1999,2,4,0,0,0,0,0,0,0.0,AUS,1998,1999
2538,JW D'Arcy,1958-1958,5,6,0,0,0,0,0,0,0.0,NZ,1958,1958
2539,EQ Davies,1936-1939,5,6,0,0,0,0,0,0,0.0,SA,1936,1939
2540,SP Davis,1986-1986,1,1,0,0,0,0,0,0,0.0,AUS,1986,1986
2541,AC Dawson,2003-2003,2,4,0,0,0,0,0,0,0.0,SA,2003,2003
2542,EW Dawson,1928-1930,5,8,0,0,0,0,0,0,0.0,ENG,1928,1930
2543,Z de Bruyn,2004-2004,3,5,0,0,0,0,0,0,0.0,SA,2004,2004
2544,RP de Groen,1993-1994,5,7,0,0,0,0,0,0,0.0,NZ,1993,1994
2545,AR Dell,1971-1974,2,4,0,0,0,0,0,0,0.0,AUS,1971,1974
2546,GRA de Silva,1982-1982,4,8,0,0,0,0,0,0,0.0,SL,1982,1982
2547,DT Dewdney,1955-1958,9,16,0,0,0,0,0,0,0.0,WI,1955,1958
2548,JG Dewes,1948-1950,5,8,0,0,0,0,0,0,0.0,ENG,1948,1950
2549,AE Dipper,1921-1921,1,2,0,0,0,0,0,0,0.0,ENG,1921,1921
2550,GH Dockrell,2019-2019,1,2,0,0,0,0,0,0,0.0,IRE,2019,2019
2551,RG Draper,1950-1950,2,3,0,0,0,0,0,0,0.0,SA,1950,1950
2552,JRF Duncan,1971-1971,1,2,0,0,0,0,0,0,0.0,AUS,1971,1971
2553,FJ Durston,1921-1921,1,2,0,0,0,0,0,0,0.0,ENG,1921,1921
2554,DV Dyer,1947-1947,3,6,0,0,0,0,0,0,0.0,SA,1947,1947
2555,KH Eastwood,1971-1971,1,2,0,0,0,0,0,0,0.0,AUS,1971,1971
2556,HI Ebeling,1934-1934,1,2,0,0,0,0,0,0,0.0,AUS,1934,1934
2557,RM Edwards,1968-1969,5,9,0,0,0,0,0,0,0.0,WI,1968,1969
2558,WJ Edwards,1974-1974,3,6,0,0,0,0,0,0,0.0,AUS,1974,1974
2559,Ehsanul Haque,2002-2002,1,1,0,0,0,0,0,0,0.0,BDESH,2002,2002
2560,Ehsan Adil,2013-2015,3,5,0,0,0,0,0,0,0.0,PAK,2013,2015
2561,RWG Emery,1952-1952,2,3,0,0,0,0,0,0,0.0,NZ,1952,1952
2562,GM Emmett,1948-1948,1,2,0,0,0,0,0,0,0.0,ENG,1948,1948
2563,AJ Evans,1921-1921,1,2,0,0,0,0,0,0,0.0,ENG,1921,1921
2564,Faheem Ashraf,2018-2019,4,7,0,0,0,0,0,0,0.0,PAK,2018,2019
2565,Faisal Hossain,2004-2004,1,2,0,0,0,0,0,0,0.0,BDESH,2004,2004
2566,Farhan Adil,2003-2003,1,2,0,0,0,0,0,0,0.0,PAK,2003,2003
2567,Farooq Hamid,1964-1964,1,2,0,0,0,0,0,0,0.0,PAK,1964,1964
2568,Farrukh Zaman,1976-1976,1,2,0,0,0,0,0,0,0.0,PAK,1976,1976
2569,JP Faulkner,2013-2013,1,2,0,0,0,0,0,0,0.0,AUS,2013,2013
2570,CJ Ferguson,2016-2016,1,1,0,0,0,0,0,0,0.0,AUS,2016,2016
2571,LH Ferguson,2019-2019,1,2,0,0,0,0,0,0,0.0,NZ,2019,2019
2572,MP Fernandes,1928-1930,2,3,0,0,0,0,0,0,0.0,WI,1928,1930
2573,ERNS Fernando,1983-1984,5,8,0,0,0,0,0,0,0.0,SL,1983,1984
2574,KADM Fernando,2003-2003,2,4,0,0,0,0,0,0,0.0,SL,2003,2003
2575,NR Ferreira,2005-2005,1,1,0,0,0,0,0,0,0.0,ZIM,2005,2005
2576,CE Finlason,1889-1889,1,2,0,0,0,0,0,0,0.0,SA,1889,1889
2577,FE Fisher,1953-1953,1,1,0,0,0,0,0,0,0.0,NZ,1953,1953
2578,JA Flavell,1961-1964,4,7,0,0,0,0,0,0,0.0,ENG,1961,1964
2579,LO Fleetwood-Smith,1935-1938,10,18,0,0,0,0,0,0,0.0,AUS,1935,1938
2580,CE Floquet,1910-1910,1,2,0,0,0,0,0,0,0.0,SA,1910,1910
2581,H Foley,1930-1930,1,2,0,0,0,0,0,0,0.0,NZ,1930,1930
2582,AJ Fothergill,1889-1889,2,4,0,0,0,0,0,0,0.0,ENG,1889,1889
2583,CN Frank,1921-1921,3,6,0,0,0,0,0,0,0.0,SA,1921,1921
2584,WHB Frank,1896-1896,1,1,0,0,0,0,0,0,0.0,SA,1896,1896
2585,MC Frederick,1954-1954,1,2,0,0,0,0,0,0,0.0,WI,1954,1954
2586,DL Freeman,1933-1933,2,2,0,0,0,0,0,0,0.0,NZ,1933,1933
2587,FAW Freer,1946-1946,1,2,0,0,0,0,0,0,0.0,AUS,1946,1946
2588,RL Fuller,1935-1935,1,2,0,0,0,0,0,0,0.0,WI,1935,1935
2589,HA Furlonge,1955-1956,3,5,0,0,0,0,0,0,0.0,WI,1955,1956
2590,HG Gaekwad,1952-1952,1,1,0,0,0,0,0,0,0.0,INDIA,1952,1952
2591,IS Gallage,1999-1999,1,2,0,0,0,0,0,0,0.0,SL,1999,1999
2592,N Gallichan,1937-1937,1,2,0,0,0,0,0,0,0.0,NZ,1937,1937
2593,PLS Gamage,2017-2018,5,9,0,0,0,0,0,0,0.0,SL,2017,2018
2594,D Ganesh,1997-1997,4,7,0,0,0,0,0,0,0.0,INDIA,1997,1997
2595,AG Ganteaume,1948-1948,1,2,0,0,0,0,0,0,0.0,WI,1948,1948
2596,SG Gedye,1964-1965,4,8,0,0,0,0,0,0,0.0,NZ,1964,1965
2597,PR George,2010-2010,1,2,0,0,0,0,0,0,0.0,AUS,2010,2010
2598,MEZ Ghazali,1954-1954,2,2,0,0,0,0,0,0,0.0,PAK,1954,1954
2599,Ghulam Abbas,1967-1967,1,2,0,0,0,0,0,0,0.0,PAK,1967,1967
2600,OD Gibson,1995-1999,2,4,0,0,0,0,0,0,0.0,WI,1995,1999
2601,ESH Giddins,1999-2000,4,7,0,0,0,0,0,0,0.0,ENG,1999,2000
2602,DR Gilbert,1985-1986,9,13,0,0,0,0,0,0,0.0,AUS,1985,1986
2603,SR Gillespie,1986-1986,1,1,0,0,0,0,0,0,0.0,NZ,1986,1986
2604,AHH Gilligan,1930-1930,4,6,0,0,0,0,0,0,0.0,ENG,1930,1930
2605,G Gladstone,1930-1930,1,2,0,0,0,0,0,0,0.0,WI,1930,1930
2606,GK Glover,1896-1896,1,1,0,0,0,0,0,0,0.0,SA,1896,1896
2607,DW Gregory,1877-1879,3,6,0,0,0,0,0,0,0.0,AUS,1877,1879
2608,IA Greig,1982-1982,2,4,0,0,0,0,0,0,0.0,ENG,1982,1982
2609,BAF Grieve,1889-1889,2,4,0,0,0,0,0,0,0.0,ENG,1889,1889
2610,GM Griffin,1960-1960,2,3,0,0,0,0,0,0,0.0,SA,1960,1960
2611,TU Groube,1880-1880,1,2,0,0,0,0,0,0,0.0,AUS,1880,1880
2612,CEJ Guest,1963-1963,1,2,0,0,0,0,0,0,0.0,AUS,1963,1963
2613,RPW Guneratne,1983-1983,1,1,0,0,0,0,0,0,0.0,SL,1983,1983
2614,BP Gupte,1961-1965,3,5,0,0,0,0,0,0,0.0,INDIA,1961,1965
2615,A Habib,1999-1999,2,4,0,0,0,0,0,0,0.0,ENG,1999,1999
2616,GG Hall,1965-1965,1,2,0,0,0,0,0,0,0.0,SA,1965,1965
2617,C Hallows,1921-1928,2,3,0,0,0,0,0,0,0.0,ENG,1921,1928
2618,GM Hamilton,1999-1999,1,1,0,0,0,0,0,0,0.0,ENG,1999,1999
2619,RHM Hands,1914-1914,1,2,0,0,0,0,0,0,0.0,SA,1914,1914
2620,MA Hanley,1949-1949,1,2,0,0,0,0,0,0,0.0,SA,1949,1949
2621,HTW Hardinge,1921-1921,1,2,0,0,0,0,0,0,0.0,ENG,1921,1921
2622,NS Harford,1955-1958,8,11,0,0,0,0,0,0,0.0,NZ,1955,1958
2623,RM Harris,1959-1959,2,2,0,0,0,0,0,0,0.0,NZ,1959,1959
2624,GPD Hartigan,1912-1914,5,6,0,0,0,0,0,0,0.0,SA,1912,1914
2625,AEV Hartkopf,1925-1925,1,2,0,0,0,0,0,0,0.0,AUS,1925,1925
2626,MR Harvey,1947-1947,1,2,0,0,0,0,0,0,0.0,AUS,1947,1947
2627,RL Harvey,1936-1936,2,2,0,0,0,0,0,0,0.0,SA,1936,1936
2628,Harvinder Singh,1998-2001,3,6,0,0,0,0,0,0,0.0,INDIA,1998,2001
2629,GG Hearne,1892-1892,1,2,0,0,0,0,0,0,0.0,ENG,1892,1892
2630,D Hettiarachchi,2001-2001,1,2,0,0,0,0,0,0,0.0,SL,2001,2001
2631,CFW Hime,1896-1896,1,2,0,0,0,0,0,0,0.0,SA,1896,1896
2632,JR Hodges,1877-1877,2,4,0,0,0,0,0,0,0.0,AUS,1877,1877
2633,JL Hopwood,1934-1934,2,3,0,0,0,0,0,0,0.0,ENG,1934,1934
2634,AN Hornby,1879-1884,3,5,0,0,0,0,0,0,0.0,ENG,1879,1884
2635,AB Howard,1972-1972,1,1,0,0,0,0,0,0,0.0,WI,1972,1972
2636,H Howell,1920-1924,5,8,0,0,0,0,0,0,0.0,ENG,1920,1924
2637,Humayun Farhat,2001-2001,1,1,0,0,0,0,0,0,0.0,PAK,2001,2001
2638,KC Ibrahim,1948-1949,4,6,0,0,0,0,0,0,0.0,INDIA,1948,1949
2639,J Iddon,1935-1935,5,9,0,0,0,0,0,0,0.0,ENG,1935,1935
2640,Iftikhar Anjum,2006-2006,1,2,0,0,0,0,0,0,0.0,PAK,2006,2006
2641,Ijaz Faqih,1980-1988,5,8,0,0,0,0,0,0,0.0,PAK,1980,1988
2642,MC Ilott,1993-1995,5,8,0,0,0,0,0,0,0.0,ENG,1993,1995
2643,Imran Khan,2014-2019,10,19,0,0,0,0,0,0,0.0,PAK,2014,2019
2644,PJ Ingram,2010-2010,2,4,0,0,0,0,0,0,0.0,NZ,2010,2010
2645,RD Jackman,1981-1982,4,7,0,0,0,0,0,0,0.0,ENG,1981,1982
2646,AS Jaggernauth,2008-2008,1,2,0,0,0,0,0,0,0.0,WI,2008,2008
2647,LP Jai,1933-1933,1,2,0,0,0,0,0,0,0.0,INDIA,1933,1933
2648,Jalal-ud-Din,1982-1985,6,9,0,0,0,0,0,0,0.0,PAK,1982,1985
2649,SP James,1998-1998,2,4,0,0,0,0,0,0,0.0,ENG,1998,1998
2650,JA Jameson,1971-1974,4,6,0,0,0,0,0,0,0.0,ENG,1971,1974
2651,Javed Ahmadi,2018-2019,2,3,0,0,0,0,0,0,0.0,AFG,2018,2019
2652,Javed Akhtar,1962-1962,1,1,0,0,0,0,0,0,0.0,PAK,1962,1962
2653,HK Jayantilal,1971-1971,1,2,0,0,0,0,0,0,0.0,INDIA,1971,1971
2654,RSA Jayasekera,1982-1982,1,1,0,0,0,0,0,0,0.0,SL,1982,1982
2655,S Jeganathan,1983-1983,2,3,0,0,0,0,0,0,0.0,SL,1983,1983
2656,DJ Johnson,1996-1996,2,4,0,0,0,0,0,0,0.0,INDIA,1996,1996
2657,HHH Johnson,1948-1950,3,6,0,0,0,0,0,0,0.0,WI,1948,1950
2658,RL Johnson,2003-2003,3,6,0,0,0,0,0,0,0.0,ENG,2003,2003
2659,RA Jones,2003-2003,1,2,0,0,0,0,0,0,0.0,NZ,2003,2003
2660,LR Joslin,1968-1968,1,2,0,0,0,0,0,0,0.0,AUS,1968,1968
2661,Kamrul Islam Rabbi,2016-2018,7,13,0,0,0,0,0,0,0.0,BDESH,2016,2018
2662,TP Kamungozi,2014-2014,1,2,0,0,0,0,0,0,0.0,ZIM,2014,2014
2663,TE Kane,2018-2018,1,2,0,0,0,0,0,0,0.0,IRE,2018,2018
2664,HH Kanitkar,1999-2000,2,3,0,0,0,0,0,0,0.0,INDIA,1999,2000
2665,HS Kanitkar,1974-1974,2,3,0,0,0,0,0,0,0.0,INDIA,1974,1974
2666,WW Keeton,1934-1939,2,2,0,0,0,0,0,0,0.0,ENG,1934,1939
2667,GA Kempis,1889-1889,1,2,0,0,0,0,0,0,0.0,SA,1889,1889
2668,SC Kerrigan,2013-2013,1,2,0,0,0,0,0,0,0.0,ENG,2013,2013
2669,Khalid Hasan,1954-1954,1,1,0,0,0,0,0,0,0.0,PAK,1954,1954
2670,Khalid Wazir,1954-1954,2,2,0,0,0,0,0,0,0.0,PAK,1954,1954
2671,A Khan,2009-2009,1,2,0,0,0,0,0,0,0.0,ENG,2009,2009
2672,JH King,1909-1909,1,2,0,0,0,0,0,0,0.0,ENG,1909,1909
2673,SP Kinneir,1911-1911,1,2,0,0,0,0,0,0,0.0,ENG,1911,1911
2674,NA Knox,1907-1907,2,4,0,0,0,0,0,0,0.0,ENG,1907,1907
2675,CKB Kulasekara,2011-2011,1,2,0,0,0,0,0,0,0.0,SL,2011,2011
2676,UN Kulkarni,1967-1968,4,8,0,0,0,0,0,0,0.0,INDIA,1967,1968
2677,AK Kuruppuarachchi,1986-1987,2,3,0,0,0,0,0,0,0.0,SL,1986,1987
2678,A Kuruvilla,1997-1997,10,15,0,0,0,0,0,0,0.0,INDIA,1997,1997
2679,F Kuys,1899-1899,1,2,0,0,0,0,0,0,0.0,SA,1899,1899
2680,MN Lathwell,1993-1993,2,3,0,0,0,0,0,0,0.0,ENG,1993,1993
2681,DV Lawrence,1988-1992,5,10,0,0,0,0,0,0,0.0,ENG,1988,1992
2682,HW Lee,1931-1931,1,2,0,0,0,0,0,0,0.0,ENG,1931,1931
2683,JG Leggat,1952-1956,9,10,0,0,0,0,0,0,0.0,NZ,1952,1956
2684,FL le Roux,1914-1914,1,2,0,0,0,0,0,0,0.0,SA,1914,1914
2685,AR Lewis,1972-1973,9,17,0,0,0,0,0,0,0.0,ENG,1972,1973
2686,J Lewis,2006-2006,1,2,0,0,0,0,0,0,0.0,ENG,2006,2006
2687,PT Lewis,1913-1913,1,1,0,0,0,0,0,0,0.0,SA,1913,1913
2688,RN Lewis,1997-2008,5,9,0,0,0,0,0,0,0.0,WI,1997,2008
2689,GF Linde,2019-2019,1,1,0,0,0,0,0,0,0.0,SA,2019,2019
2690,DK Liyanage,1992-2001,9,15,0,0,0,0,0,0,0.0,SL,1992,2001
2691,TA Lloyd,1984-1984,1,1,0,0,0,0,0,0,0.0,ENG,1984,1984
2692,ACI Lock,1995-1995,1,2,0,0,0,0,0,0,0.0,ZIM,1995,1995
2693,GR Loveridge,1996-1996,1,2,0,0,0,0,0,0,0.0,NZ,1996,1996
2694,EB Lundie,1914-1914,1,2,0,0,0,0,0,0,0.0,SA,1914,1914
2695,MJ Macaulay,1965-1965,1,2,0,0,0,0,0,0,0.0,SA,1965,1965
2696,AR McBrine,2019-2019,2,4,0,0,0,0,0,0,0.0,IRE,2019,2019
2697,JCW MacBryan,1924-1924,1,1,0,0,0,0,0,0,0.0,ENG,1924,1924
2698,BE McGain,2009-2009,1,1,0,0,0,0,0,0,0.0,AUS,2009,2009
2699,HM McGirr,1930-1930,2,3,0,0,0,0,0,0,0.0,NZ,1930,1930
2700,PE McIntyre,1995-1996,2,4,0,0,0,0,0,0,0.0,AUS,1995,1996
2701,AJ McKay,2010-2010,1,1,0,0,0,0,0,0,0.0,NZ,2010,2010
2702,FA MacKinnon,1879-1879,1,2,0,0,0,0,0,0,0.0,ENG,1879,1879
2703,JW McLaren,1912-1912,1,2,0,0,0,0,0,0,0.0,AUS,1912,1912
2704,R McLaren,2010-2014,2,4,0,0,0,0,0,0,0.0,SA,2010,2014
2705,EG McLeod,1930-1930,1,2,0,0,0,0,0,0,0.0,NZ,1930,1930
2706,JEP McMaster,1889-1889,1,2,0,0,0,0,0,0,0.0,ENG,1889,1889
2707,DAN McRae,1946-1946,1,1,0,0,0,0,0,0,0.0,NZ,1946,1946
2708,MAWR Madurasinghe,1988-1992,3,5,0,0,0,0,0,0,0.0,SL,1988,1992
2709,Mahbubul Alam,2008-2008,4,6,0,0,0,0,0,0,0.0,BDESH,2008,2008
2710,SI Mahmood,2006-2007,8,14,0,0,0,0,0,0,0.0,ENG,2006,2007
2711,JWH Makepeace,1920-1921,4,7,0,0,0,0,0,0,0.0,ENG,1920,1921
2712,NA Mallender,1992-1992,2,4,0,0,0,0,0,0,0.0,ENG,1992,1992
2713,MF Malone,1977-1977,1,2,0,0,0,0,0,0,0.0,AUS,1977,1977
2714,LA Markham,1949-1949,1,2,0,0,0,0,0,0,0.0,SA,1949,1949
2715,VJ Marks,1982-1984,6,12,0,0,0,0,0,0,0.0,ENG,1982,1984
2716,AP Marr,1885-1885,1,2,0,0,0,0,0,0,0.0,AUS,1885,1885
2717,NE Marshall,1955-1955,1,2,0,0,0,0,0,0,0.0,WI,1955,1955
2718,BP Martin,2013-2013,5,9,0,0,0,0,0,0,0.0,NZ,2013,2013
2719,JW Martin,1947-1947,1,2,0,0,0,0,0,0,0.0,ENG,1947,1947
2720,WFE Marx,1921-1921,3,6,0,0,0,0,0,0,0.0,SA,1921,1921
2721,MJ Mason,2004-2004,1,2,0,0,0,0,0,0,0.0,NZ,2004,2004
2722,Masood Anwar,1990-1990,1,2,0,0,0,0,0,0,0.0,PAK,1990,1990
2723,PS Masvaure,2016-2016,2,3,0,0,0,0,0,0,0.0,ZIM,2016,2016
2724,EZ Matambanadzo,1996-1999,3,6,0,0,0,0,0,0,0.0,ZIM,1996,1999
2725,T Meale,1958-1958,2,3,0,0,0,0,0,0,0.0,NZ,1958,1958
2726,JM Mennie,2016-2016,1,1,0,0,0,0,0,0,0.0,AUS,2016,2016
2727,KO Meth,2013-2013,2,4,0,0,0,0,0,0,0.0,ZIM,2013,2013
2728,EM Meuli,1953-1953,1,1,0,0,0,0,0,0,0.0,NZ,1953,1953
2729,AM Miller,1896-1896,1,2,0,0,0,0,0,0,0.0,ENG,1896,1896
2730,NO Miller,2009-2009,1,2,0,0,0,0,0,0,0.0,WI,2009,2009
2731,RC Miller,1953-1953,1,2,0,0,0,0,0,0,0.0,WI,1953,1953
2732,RB Minnett,1911-1912,9,16,0,0,0,0,0,0,0.0,AUS,1911,1912
2733,Miran Bakhsh,1955-1955,2,4,0,0,0,0,0,0,0.0,PAK,1955,1955
2734,SF Mire,2017-2017,2,3,0,0,0,0,0,0,0.0,ZIM,2017,2017
2735,Mir Hamza,2018-2018,1,2,0,0,0,0,0,0,0.0,PAK,2018,2018
2736,DJ Mitchell,2019-2019,1,1,0,0,0,0,0,0,0.0,NZ,2019,2019
2737,NS Mitchell-Innes,1935-1935,1,2,0,0,0,0,0,0,0.0,ENG,1935,1935
2738,A Mithun,2010-2011,4,8,0,0,0,0,0,0,0.0,INDIA,2010,2011
2739,Mohammad Aslam,1954-1954,1,1,0,0,0,0,0,0,0.0,PAK,1954,1954
2740,Mohammad Irfan,2013-2013,4,6,0,0,0,0,0,0,0.0,PAK,2013,2013
2741,Mohammad Khalil,2004-2005,2,4,0,0,0,0,0,0,0.0,PAK,2004,2005
2742,Mohammad Munaf,1959-1962,4,8,0,0,0,0,0,0,0.0,PAK,1959,1962
2743,Mohammad Shahid,2015-2015,5,6,0,0,0,0,0,0,0.0,BDESH,2015,2015
2744,Mohammad Shahzad,2018-2019,2,3,0,0,0,0,0,0,0.0,AFG,2018,2019
2745,Mohammad Zahid,1996-2003,5,9,0,0,0,0,0,0,0.0,PAK,1996,2003
2746,DS Mohanty,1997-1997,2,4,0,0,0,0,0,0,0.0,INDIA,1997,1997
2747,JA Morkel,2009-2009,1,2,0,0,0,0,0,0,0.0,SA,2009,2009
2748,J Moroney,1949-1952,7,13,0,0,0,0,0,0,0.0,AUS,1949,1952
2749,S Morris,1885-1885,1,2,0,0,0,0,0,0,0.0,AUS,1885,1885
2750,JK Moss,1979-1979,1,2,0,0,0,0,0,0,0.0,AUS,1979,1979
2751,VM Muddiah,1959-1960,2,3,0,0,0,0,0,0,0.0,INDIA,1959,1960
2752,GH Mudie,1935-1935,1,2,0,0,0,0,0,0,0.0,WI,1935,1935
2753,Muhammad Musa,2019-2019,1,1,0,0,0,0,0,0,0.0,PAK,2019,2019
2754,Mujeeb Ur Rahman,2018-2018,1,1,0,0,0,0,0,0,0.0,AFG,2018,2018
2755,PWA Mulder,2019-2019,1,2,0,0,0,0,0,0,0.0,SA,2019,2019
2756,C Munro,2013-2013,1,1,0,0,0,0,0,0,0.0,NZ,2013,2013
2757,TA Munton,1992-1992,2,4,0,0,0,0,0,0,0.0,ENG,1992,1992
2758,T Mupariwa,2004-2004,1,1,0,0,0,0,0,0,0.0,ZIM,2004,2004
2759,TJ Murtagh,2018-2019,3,6,0,0,0,0,0,0,0.0,IRE,2018,2019
2760,TK Musakanda,2017-2017,1,2,0,0,0,0,0,0,0.0,ZIM,2017,2017
2761,HA Musgrove,1885-1885,1,2,0,0,0,0,0,0,0.0,AUS,1885,1885
2762,DT Mutendera,2000-2000,1,2,0,0,0,0,0,0,0.0,ZIM,2000,2000
2763,F Mutizwa,2012-2012,1,1,0,0,0,0,0,0,0.0,ZIM,2012,2012
2764,B Muzarabani,2017-2017,1,1,0,0,0,0,0,0,0.0,ZIM,2017,2017
2765,W Mwayenga,2005-2005,1,2,0,0,0,0,0,0,0.0,ZIM,2005,2005
2766,Nadeem Ghauri,1990-1990,1,1,0,0,0,0,0,0,0.0,PAK,1990,1990
2767,Nadeem Khan,1993-1999,2,4,0,0,0,0,0,0,0.0,PAK,1993,1999
2768,LE Nagel,1932-1932,1,2,0,0,0,0,0,0,0.0,AUS,1932,1932
2769,SS Naik,1974-1975,3,4,0,0,0,0,0,0,0.0,INDIA,1974,1975
2770,Naoomal Jaoomal,1932-1934,3,6,0,0,0,0,0,0,0.0,INDIA,1932,1934
2771,Naseem Shah,2019-2019,3,4,0,0,0,0,0,0,0.0,PAK,2019,2019
2772,Nasir Jamal,2019-2019,1,2,0,0,0,0,0,0,0.0,AFG,2019,2019
2773,Naved Anjum,1989-1990,2,4,0,0,0,0,0,0,0.0,PAK,1989,1990
2774,Naved Ashraf,1998-2000,2,4,0,0,0,0,0,0,0.0,PAK,1998,2000
2775,Naved Latif,2002-2002,1,2,0,0,0,0,0,0,0.0,PAK,2002,2002
2776,MN Nawaz,2002-2002,1,2,0,0,0,0,0,0,0.0,SL,2002,2002
2777,S Nazir Ali,1932-1934,2,4,0,0,0,0,0,0,0.0,INDIA,1932,1934
2778,Nazmul Hossain,2004-2011,2,3,0,0,0,0,0,0,0.0,BDESH,2004,2011
2779,Nazmul Islam,2018-2018,1,2,0,0,0,0,0,0,0.0,BDESH,2018,2018
2780,JM Neblett,1935-1935,1,2,0,0,0,0,0,0,0.0,WI,1935,1935
2781,W Newham,1888-1888,1,2,0,0,0,0,0,0,0.0,ENG,1888,1888
2782,J Newman,1932-1933,3,3,0,0,0,0,0,0,0.0,NZ,1932,1933
2783,MJ Nicholson,1998-1998,1,2,0,0,0,0,0,0,0.0,AUS,1998,1998
2784,JFW Nicolson,1928-1928,3,6,0,0,0,0,0,0,0.0,SA,1928,1928
2785,RAP Nissanka,2003-2003,4,7,0,0,0,0,0,0,0.0,SL,2003,2003
2786,A Nortje,2019-2019,3,4,0,0,0,0,0,0,0.0,SA,2019,2019
2787,NO Norton,1910-1910,1,2,0,0,0,0,0,0,0.0,SA,1910,1910
2788,OE Nothling,1928-1928,1,2,0,0,0,0,0,0,0.0,AUS,1928,1928
2789,S Nyalchand,1952-1952,1,1,0,0,0,0,0,0,0.0,INDIA,1952,1952
2790,KJ O'Brien,2018-2019,3,6,0,0,0,0,0,0,0.0,IRE,2018,2019
2791,AE Ochse,1889-1889,2,3,0,0,0,0,0,0,0.0,SA,1889,1889
2792,SNJ O'Keefe,2014-2017,9,16,0,0,0,0,0,0,0.0,AUS,2014,2017
2793,N Oldfield,1939-1939,1,1,0,0,0,0,0,0,0.0,ENG,1939,1939
2794,AH Omarshah,1992-1996,3,5,0,0,0,0,0,0,0.0,ZIM,1992,1996
2795,G Onions,2009-2012,9,16,0,0,0,0,0,0,0.0,ENG,2009,2012
2796,J Ormond,2001-2001,2,3,0,0,0,0,0,0,0.0,ENG,2001,2001
2797,DEV Padgett,1960-1960,2,4,0,0,0,0,0,0,0.0,ENG,1960,1960
2798,AL Padmore,1976-1976,2,4,0,0,0,0,0,0,0.0,WI,1976,1976
2799,DJ Pagon,2005-2005,2,4,0,0,0,0,0,0,0.0,WI,2005,2005
2800,AM Pai,1969-1969,1,2,0,0,0,0,0,0,0.0,INDIA,1969,1969
2801,PE Palia,1932-1936,2,4,0,0,0,0,0,0,0.0,INDIA,1932,1936
2802,CH Palmer,1954-1954,1,2,0,0,0,0,0,0,0.0,ENG,1954,1954
2803,KE Palmer,1965-1965,1,2,0,0,0,0,0,0,0.0,ENG,1965,1965
2804,RL Park,1920-1921,1,2,0,0,0,0,0,0,0.0,AUS,1920,1921
2805,RD Parkar,1972-1973,2,4,0,0,0,0,0,0,0.0,INDIA,1972,1973
2806,CWL Parker,1921-1921,1,1,0,0,0,0,0,0,0.0,ENG,1921,1921
2807,GM Parker,1924-1924,2,2,0,0,0,0,0,0,0.0,SA,1924,1924
2808,PWG Parker,1981-1981,1,2,0,0,0,0,0,0,0.0,ENG,1981,1981
2809,JH Parks,1937-1937,1,2,0,0,0,0,0,0,0.0,ENG,1937,1937
2810,DD Parsana,1979-1979,2,4,0,0,0,0,0,0,0.0,INDIA,1979,1979
2811,Nawab of Pataudi snr,1932-1946,6,11,0,0,0,0,0,0,0.0,ENG/INDIA,1932,1946
2812,DJ Pattinson,2008-2008,1,2,0,0,0,0,0,0,0.0,ENG,2008,2008
2813,F Penn,1880-1880,1,2,0,0,0,0,0,0,0.0,ENG,1880,1880
2814,KK Peters,2014-2014,1,1,0,0,0,0,0,0,0.0,WI,2014,2014
2815,WN Phillips,1992-1992,1,2,0,0,0,0,0,0,0.0,AUS,1992,1992
2816,LR Pierre,1948-1948,1,2,0,0,0,0,0,0,0.0,WI,1948,1948
2817,ACS Pigott,1984-1984,1,1,0,0,0,0,0,0,0.0,ENG,1984,1984
2818,W Place,1948-1948,3,6,0,0,0,0,0,0,0.0,ENG,1948,1948
2819,JB Plimsoll,1947-1947,1,2,0,0,0,0,0,0,0.0,SA,1947,1947
2820,GH Pope,1947-1947,1,2,0,0,0,0,0,0,0.0,ENG,1947,1947
2821,RJ Pope,1885-1885,1,2,0,0,0,0,0,0,0.0,AUS,1885,1885
2822,RR Powar,2007-2007,2,4,0,0,0,0,0,0,0.0,INDIA,2007,2007
2823,S Prasanna,2011-2011,1,1,0,0,0,0,0,0,0.0,SL,2011,2011
2824,D Pretorius,2002-2003,4,8,0,0,0,0,0,0,0.0,SA,2002,2003
2825,RM Prideaux,1968-1969,3,6,0,0,0,0,0,0,0.0,ENG,1968,1969
2826,MW Priest,1990-1998,3,5,0,0,0,0,0,0,0.0,NZ,1990,1998
2827,CFH Prince,1899-1899,1,2,0,0,0,0,0,0,0.0,SA,1899,1899
2828,MW Pringle,1992-1995,4,7,0,0,0,0,0,0,0.0,SA,1992,1995
2829,Qaiser Abbas,2000-2000,1,2,0,0,0,0,0,0,0.0,PAK,2000,2000
2830,Qais Ahmad,2019-2019,1,2,0,0,0,0,0,0,0.0,AFG,2019,2019
2831,NV Radford,1986-1988,3,6,0,0,0,0,0,0,0.0,ENG,1986,1988
2832,Rafiqul Islam,2002-2002,1,1,0,0,0,0,0,0,0.0,BDESH,2002,2002
2833,S Ragoonath,1999-1999,2,4,0,0,0,0,0,0,0.0,WI,1999,1999
2834,K Rai Singh,1948-1948,1,2,0,0,0,0,0,0,0.0,INDIA,1948,1948
2835,Rajinder Pal,1964-1964,1,2,0,0,0,0,0,0,0.0,INDIA,1964,1964
2836,C Ramaswami,1936-1936,2,3,0,0,0,0,0,0,0.0,INDIA,1936,1936
2837,AN Ranasinghe,1982-1982,2,4,0,0,0,0,0,0,0.0,SL,1982,1982
2838,D Ranatunga,1989-1989,2,4,0,0,0,0,0,0,0.0,SL,1989,1989
2839,U Ranchod,1993-1993,1,1,0,0,0,0,0,0,0.0,ZIM,1993,1993
2840,CR Rangachari,1948-1948,4,4,0,0,0,0,0,0,0.0,INDIA,1948,1948
2841,WB Rankin,2014-2019,3,6,0,0,0,0,0,0,0.0,ENG/IRE,2014,2019
2842,Rashid Khan,2018-2019,4,7,0,0,0,0,0,0,0.0,AFG,2018,2019
2843,V Razdan,1989-1989,2,2,0,0,0,0,0,0,0.0,INDIA,1989,1989
2844,HD Read,1935-1935,1,2,0,0,0,0,0,0,0.0,ENG,1935,1935
2845,RE Redmond,1973-1973,1,2,0,0,0,0,0,0,0.0,NZ,1973,1973
2846,N Reid,1921-1921,1,2,0,0,0,0,0,0,0.0,SA,1921,1921
2847,RA Reifer,2017-2017,1,2,0,0,0,0,0,0,0.0,WI,2017,2017
2848,HJ Rhodes,1959-1959,2,4,0,0,0,0,0,0,0.0,ENG,1959,1959
2849,Riaz Afridi,2004-2004,1,2,0,0,0,0,0,0,0.0,PAK,2004,2004
2850,AR Richards,1896-1896,1,1,0,0,0,0,0,0,0.0,SA,1896,1896
2851,WHM Richards,1889-1889,1,1,0,0,0,0,0,0,0.0,SA,1889,1889
2852,JA Richardson,2019-2019,2,4,0,0,0,0,0,0,0.0,AUS,2019,2019
2853,TL Richmond,1921-1921,1,2,0,0,0,0,0,0,0.0,ENG,1921,1921
2854,KR Rickards,1948-1952,2,4,0,0,0,0,0,0,0.0,WI,1948,1952
2855,AT Roberts,1956-1956,1,2,0,0,0,0,0,0,0.0,WI,1956,1956
2856,LA Roberts,1999-1999,1,2,0,0,0,0,0,0,0.0,WI,1999,1999
2857,GK Robertson,1986-1986,1,2,0,0,0,0,0,0,0.0,NZ,1986,1986
2858,WR Robertson,1885-1885,1,2,0,0,0,0,0,0,0.0,AUS,1885,1885
2859,TS Roland-Jones,2017-2017,4,8,0,0,0,0,0,0,0.0,ENG,2017,2017
2860,AK Roy,1969-1969,4,8,0,0,0,0,0,0,0.0,INDIA,1969,1969
2861,FE Rumsey,1964-1965,5,10,0,0,0,0,0,0,0.0,ENG,1964,1965
2862,MW Rushmere,1992-1992,1,2,0,0,0,0,0,0,0.0,SA,1992,1992
2863,JW Rutherford,1956-1956,1,2,0,0,0,0,0,0,0.0,AUS,1956,1956
2864,Sajedul Islam,2008-2013,3,5,0,0,0,0,0,0,0.0,BDESH,2008,2013
2865,RL Sanghvi,2001-2001,1,2,0,0,0,0,0,0,0.0,INDIA,2001,2001
2866,CT Sarwate,1946-1951,9,13,0,0,0,0,0,0,0.0,INDIA,1946,1951
2867,RC Saxena,1967-1967,1,2,0,0,0,0,0,0,0.0,INDIA,1967,1967
2868,CP Schofield,2000-2000,2,4,0,0,0,0,0,0,0.0,ENG,2000,2000
2869,SS Schultz,1879-1879,1,2,0,0,0,0,0,0,0.0,ENG,1879,1879
2870,AHP Scott,1953-1953,1,2,0,0,0,0,0,0,0.0,WI,1953,1953
2871,OC Scott,1928-1931,8,11,0,0,0,0,0,0,0.0,WI,1928,1931
2872,RH Scott,1947-1947,1,1,0,0,0,0,0,0,0.0,NZ,1947,1947
2873,BJ Sealey,1933-1933,1,1,0,0,0,0,0,0,0.0,WI,1933,1933
2874,TAP Sekhar,1983-1983,2,2,0,0,0,0,0,0,0.0,INDIA,1983,1983
2875,AK Sengupta,1959-1959,1,2,0,0,0,0,0,0,0.0,INDIA,1959,1959
2876,DG Sewell,1997-1997,1,2,0,0,0,0,0,0,0.0,NZ,1997,1997
2877,Shafiq Ahmed,1974-1981,6,10,0,0,0,0,0,0,0.0,PAK,1974,1981
2878,Shaheen Shah Afridi,2018-2019,7,11,0,0,0,0,0,0,0.0,PAK,2018,2019
2879,Shahid Mahboob,1989-1989,1,1,0,0,0,0,0,0,0.0,PAK,1989,1989
2880,Shahid Mahmood,1962-1962,1,1,0,0,0,0,0,0,0.0,PAK,1962,1962
2881,Shahid Saeed,1989-1989,1,2,0,0,0,0,0,0,0.0,PAK,1989,1989
2882,T Shamsi,2016-2018,2,4,0,0,0,0,0,0,0.0,SA,2016,2018
2883,Sharjeel Khan,2017-2017,1,2,0,0,0,0,0,0,0.0,PAK,2017,2017
2884,KV Sharma,2014-2014,1,2,0,0,0,0,0,0,0.0,INDIA,2014,2014
2885,SG Shinde,1946-1952,7,13,0,0,0,0,0,0,0.0,INDIA,1946,1952
2886,RC Shukla,1982-1982,1,2,0,0,0,0,0,0,0.0,INDIA,1982,1982
2887,J Shuter,1888-1888,1,2,0,0,0,0,0,0,0.0,ENG,1888,1888
2888,A Sidebottom,1985-1985,1,1,0,0,0,0,0,0,0.0,ENG,1985,1985
2889,RA Sinfield,1938-1938,1,2,0,0,0,0,0,0,0.0,ENG,1938,1938
2890,KN Slater,1959-1959,1,2,0,0,0,0,0,0,0.0,AUS,1959,1959
2891,J Slight,1880-1880,1,2,0,0,0,0,0,0,0.0,AUS,1880,1880
2892,TF Smailes,1946-1946,1,2,0,0,0,0,0,0,0.0,ENG,1946,1946
2893,MA Small,1984-1984,2,4,0,0,0,0,0,0,0.0,WI,1984,1984
2894,AM Smith,1997-1997,1,1,0,0,0,0,0,0,0.0,ENG,1997,1997
2895,CA Smith,1889-1889,1,2,0,0,0,0,0,0,0.0,ENG,1889,1889
2896,DBM Smith,1912-1912,2,3,0,0,0,0,0,0,0.0,AUS,1912,1912
2897,DM Smith,1986-1986,2,4,0,0,0,0,0,0,0.0,ENG,1986,1986
2898,DV Smith,1957-1957,3,6,0,0,0,0,0,0,0.0,ENG,1957,1957
2899,HD Smith,1933-1933,1,1,0,0,0,0,0,0,0.0,NZ,1933,1933
2900,GA Smithson,1948-1948,2,4,0,0,0,0,0,0,0.0,ENG,1948,1948
2901,CA Snedden,1947-1947,1,1,0,0,0,0,0,0,0.0,NZ,1947,1947
2902,Sohrawordi Shuvo,2011-2011,1,2,0,0,0,0,0,0,0.0,BDESH,2011,2011
2903,WER Somerville,2018-2019,3,6,0,0,0,0,0,0,0.0,NZ,2018,2019
2904,MM Sood,1960-1960,1,1,0,0,0,0,0,0,0.0,INDIA,1960,1960
2905,TE Srinivasan,1981-1981,1,2,0,0,0,0,0,0,0.0,INDIA,1981,1981
2906,SJ Staples,1928-1928,3,6,0,0,0,0,0,0,0.0,ENG,1928,1928
2907,SC Stayers,1962-1962,4,8,0,0,0,0,0,0,0.0,WI,1962,1962
2908,JP Stephenson,1989-1989,1,2,0,0,0,0,0,0,0.0,ENG,1989,1989
2909,GB Stevenson,1980-1981,2,3,0,0,0,0,0,0,0.0,ENG,1980,1981
2910,PJR Steyn,1995-1995,3,6,0,0,0,0,0,0,0.0,SA,1995,1995
2911,EL St Hill,1930-1930,2,4,0,0,0,0,0,0,0.0,WI,1930,1930
2912,VH Stollmeyer,1939-1939,1,2,0,0,0,0,0,0,0.0,WI,1939,1939
2913,OP Stone,2019-2019,1,2,0,0,0,0,0,0,0.0,ENG,2019,2019
2914,Subashis Roy,2017-2017,4,7,0,0,0,0,0,0,0.0,BDESH,2017,2017
2915,FH Sugg,1888-1888,2,4,0,0,0,0,0,0,0.0,ENG,1888,1888
2916,GR Sunderam,1955-1956,2,4,0,0,0,0,0,0,0.0,INDIA,1955,1956
2917,Sunzamul Islam,2018-2018,1,1,0,0,0,0,0,0,0.0,BDESH,2018,2018
2918,VN Swamy,1955-1955,1,2,0,0,0,0,0,0,0.0,INDIA,1955,1955
2919,Syed Rasel,2005-2007,6,8,0,0,0,0,0,0,0.0,BDESH,2005,2007
2920,HM Taberer,1902-1902,1,2,0,0,0,0,0,0,0.0,SA,1902,1902
2921,VM Tancred,1899-1899,1,2,0,0,0,0,0,0,0.0,SA,1899,1899
2922,LE Tapscott,1923-1923,2,4,0,0,0,0,0,0,0.0,SA,1923,1923
2923,KK Tarapore,1948-1948,1,1,0,0,0,0,0,0,0.0,INDIA,1948,1948
2924,AI Taylor,1956-1956,1,2,0,0,0,0,0,0,0.0,SA,1956,1956
2925,D Taylor,1914-1914,2,4,0,0,0,0,0,0,0.0,SA,1914,1914
2926,JO Taylor,1958-1959,3,5,0,0,0,0,0,0,0.0,WI,1958,1959
2927,JP Taylor,1993-1994,2,4,0,0,0,0,0,0,0.0,ENG,1993,1994
2928,SN Thakur,2018-2018,1,2,0,0,0,0,0,0,0.0,INDIA,2018,2018
2929,NHCD Theunissen,1889-1889,1,1,0,0,0,0,0,0,0.0,SA,1889,1889
2930,JG Thomas,1986-1986,5,9,0,0,0,0,0,0,0.0,ENG,1986,1986
2931,PIC Thompson,1996-1997,2,3,0,0,0,0,0,0,0.0,WI,1996,1997
2932,SR Thompson,2018-2019,3,6,0,0,0,0,0,0,0.0,IRE,2018,2019
2933,GR Thoms,1952-1952,1,2,0,0,0,0,0,0,0.0,AUS,1952,1952
2934,AL Thomson,1970-1971,4,8,0,0,0,0,0,0,0.0,AUS,1970,1971
2935,K Thomson,1968-1968,2,4,0,0,0,0,0,0,0.0,NZ,1968,1968
2936,HM Thurlow,1932-1932,1,2,0,0,0,0,0,0,0.0,AUS,1932,1932
2937,DS Tomlinson,1935-1935,1,1,0,0,0,0,0,0,0.0,SA,1935,1935
2938,GC Tonge,2009-2009,1,2,0,0,0,0,0,0,0.0,WI,2009,2009
2939,CL Townsend,1899-1899,2,4,0,0,0,0,0,0,0.0,ENG,1899,1899
2940,MF Tremlett,1948-1948,3,6,0,0,0,0,0,0,0.0,ENG,1948,1948
2941,GE Tribe,1946-1947,3,6,0,0,0,0,0,0,0.0,AUS,1946,1947
2942,PS Twentyman-Jones,1902-1902,1,2,0,0,0,0,0,0,0.0,SA,1902,1902
2943,EJ Tyler,1896-1896,1,2,0,0,0,0,0,0,0.0,ENG,1896,1896
2944,JD Unadkat,2010-2010,1,1,0,0,0,0,0,0,0.0,INDIA,2010,2010
2945,KEA Upashantha,1999-2002,2,4,0,0,0,0,0,0,0.0,SL,1999,2002
2946,Usman Salahuddin,2018-2018,1,1,0,0,0,0,0,0,0.0,PAK,2018,2018
2947,Usman Shinwari,2019-2019,1,1,0,0,0,0,0,0,0.0,PAK,2019,2019
2948,VA Valentine,1933-1933,2,2,0,0,0,0,0,0,0.0,WI,1933,1933
2949,RH Vance,1988-1989,4,4,0,0,0,0,0,0,0.0,NZ,1988,1989
2950,GD Varnals,1964-1965,3,4,0,0,0,0,0,0,0.0,SA,1964,1965
2951,GF Vernon,1882-1883,1,2,0,0,0,0,0,0,0.0,ENG,1882,1883
2952,GC Viljoen,2016-2016,1,2,0,0,0,0,0,0,0.0,SA,2016,2016
2953,R Vinay Kumar,2012-2012,1,1,0,0,0,0,0,0,0.0,INDIA,2012,2012
2954,J Vine,1912-1912,2,4,0,0,0,0,0,0,0.0,ENG,1912,1912
2955,Wafadar Momand,2018-2019,2,3,0,0,0,0,0,0,0.0,AFG,2018,2019
2956,LA Walcott,1930-1930,1,2,0,0,0,0,0,0,0.0,WI,1930,1930
2957,BGK Walker,2000-2002,5,8,0,0,0,0,0,0,0.0,NZ,2000,2002
2958,KP Walmsley,1995-2000,3,6,0,0,0,0,0,0,0.0,NZ,1995,2000
2959,Waqar Salamkheil,2019-2019,1,2,0,0,0,0,0,0,0.0,AFG,2019,2019
2960,KPJ Warnaweera,1986-1994,10,15,0,0,0,0,0,0,0.0,SL,1986,1994
2961,JJ Warr,1951-1951,2,3,0,0,0,0,0,0,0.0,ENG,1951,1951
2962,BT Watambwa,2001-2002,6,11,0,0,0,0,0,0,0.0,ZIM,2001,2002
2963,L Watt,1955-1955,1,2,0,0,0,0,0,0,0.0,NZ,1955,1955
2964,MG Webb,1971-1974,3,6,0,0,0,0,0,0,0.0,NZ,1971,1974
2965,KH Weekes,1939-1939,2,4,0,0,0,0,0,0,0.0,WI,1939,1939
2966,CDUS Weerasinghe,1985-1985,1,2,0,0,0,0,0,0,0.0,SL,1985,1985
2967,AP Wells,1995-1995,1,1,0,0,0,0,0,0,0.0,ENG,1995,1995
2968,RJ Westcott,1954-1958,5,8,0,0,0,0,0,0,0.0,SA,1954,1958
2969,A Wharton,1949-1949,1,2,0,0,0,0,0,0,0.0,ENG,1949,1949
2970,DJ White,1990-1990,2,3,0,0,0,0,0,0,0.0,NZ,1990,1990
2971,DW White,1961-1962,2,4,0,0,0,0,0,0,0.0,ENG,1961,1962
2972,PE Whitelaw,1933-1933,2,2,0,0,0,0,0,0,0.0,NZ,1933,1933
2973,CV Wight,1928-1930,2,3,0,0,0,0,0,0,0.0,WI,1928,1930
2974,GL Wight,1953-1953,1,2,0,0,0,0,0,0,0.0,WI,1953,1953
2975,KIW Wijegunawardene,1991-1992,2,4,0,0,0,0,0,0,0.0,SL,1991,1992
2976,G Wijekoon,2005-2005,2,4,0,0,0,0,0,0,0.0,SL,2005,2005
2977,PK Wijetunge,1993-1993,1,2,0,0,0,0,0,0,0.0,SL,1993,1993
2978,CA Wiles,1933-1933,1,1,0,0,0,0,0,0,0.0,WI,1933,1933
2979,LL Wilkinson,1938-1939,3,5,0,0,0,0,0,0,0.0,ENG,1938,1939
2980,ET Willett,1973-1975,5,10,0,0,0,0,0,0,0.0,WI,1973,1975
2981,NF Williams,1990-1990,1,1,0,0,0,0,0,0,0.0,ENG,1990,1990
2982,CM Willoughby,2003-2003,2,4,0,0,0,0,0,0,0.0,SA,2003,2003
2983,JT Willoughby,1896-1896,2,3,0,0,0,0,0,0,0.0,SA,1896,1896
2984,CEM Wilson,1899-1899,2,4,0,0,0,0,0,0,0.0,ENG,1899,1899
2985,ER Wilson,1921-1921,1,2,0,0,0,0,0,0,0.0,ENG,1921,1921
2986,JW Wilson,1956-1956,1,2,0,0,0,0,0,0,0.0,AUS,1956,1956
2987,P Wilson,1998-1998,1,1,0,0,0,0,0,0,0.0,AUS,1998,1998
2988,CS Wimble,1892-1892,1,1,0,0,0,0,0,0,0.0,SA,1892,1892
2989,KL Wishart,1935-1935,1,2,0,0,0,0,0,0,0.0,WI,1935,1935
2990,R Wood,1887-1887,1,2,0,0,0,0,0,0,0.0,ENG,1887,1887
2991,CW Wright,1896-1896,3,6,0,0,0,0,0,0,0.0,ENG,1896,1896
2992,EG Wynyard,1896-1906,3,6,0,0,0,0,0,0,0.0,ENG,1896,1906
2993,Yamin Ahmadzai,2018-2019,4,7,0,0,0,0,0,0,0.0,AFG,2018,2019
2994,Yasir Ali,2003-2003,1,2,0,0,0,0,0,0,0.0,PAK,2003,2003
2995,Yasir Arafat,2007-2009,3,5,0,0,0,0,0,0,0.0,PAK,2007,2009
2996,B Yograj Singh,1981-1981,1,2,0,0,0,0,0,0,0.0,INDIA,1981,1981
2997,S Young,1997-1997,1,2,0,0,0,0,0,0,0.0,AUS,1997,1997
2998,Younis Ahmed,1969-1987,4,7,0,0,0,0,0,0,0.0,PAK,1969,1987
2999,Zahir Khan,2019-2019,2,4,0,0,0,0,0,0,0.0,AFG,2019,2019
3000,Ziaur Rahman,2013-2013,1,2,0,0,0,0,0,0,0.0,BDESH,2013,2013
